Date,Cost,Credit,Balance,Type
5/15/2020,$8.59,$0.00,$3409.93,Print
5/15/2020,$3.25,$0.00,$3418.52,Print
5/15/2020,$2.74,$0.00,$3421.77,Print
5/15/2020,$3.31,$0.00,$3424.51,Print
5/15/2020,$3.21,$0.00,$3427.82,Print
5/15/2020,$2.76,$0.00,$3431.03,Print
5/15/2020,$3.25,$0.00,$3433.79,Print
5/15/2020,$3.25,$0.00,$3437.04,Print
5/15/2020,$3.23,$0.00,$3440.29,Print
5/15/2020,$3.25,$0.00,$3443.52,Print
5/15/2020,$2.84,$0.00,$3446.77,Print
5/15/2020,$2.74,$0.00,$3449.61,Print
5/15/2020,$4.08,$0.00,$3452.35,Print
5/15/2020,$2.74,$0.00,$3456.43,Print
5/15/2020,$3.21,$0.00,$3459.17,Print
5/15/2020,$5.27,$0.00,$3462.38,Print
5/15/2020,$3.39,$0.00,$3467.65,Print
5/15/2020,$2.84,$0.00,$3471.04,Print
5/15/2020,$3.25,$0.00,$3473.88,Print
5/15/2020,$2.78,$0.00,$3477.13,Print
5/15/2020,$2.74,$0.00,$3479.91,Print
5/15/2020,$2.78,$0.00,$3482.65,Print
5/15/2020,$2.78,$0.00,$3485.43,Print
5/15/2020,$3.25,$0.00,$3488.21,Print
5/15/2020,$3.21,$0.00,$3491.46,Print
5/15/2020,$3.52,$0.00,$3494.67,Print
5/15/2020,$2.84,$0.00,$3498.19,Print
5/15/2020,$4.00,$0.00,$3501.03,Print
5/15/2020,$3.21,$0.00,$3505.03,Print
5/15/2020,$3.25,$0.00,$3508.24,Print
5/15/2020,$3.21,$0.00,$3511.49,Print
5/15/2020,$3.52,$0.00,$3514.70,Print
5/15/2020,$3.25,$0.00,$3518.22,Print
5/15/2020,$3.52,$0.00,$3521.47,Print
5/15/2020,$2.78,$0.00,$3524.99,Print
5/15/2020,$3.25,$0.00,$3527.77,Print
5/15/2020,$3.25,$0.00,$3531.02,Print
5/15/2020,$3.21,$0.00,$3534.27,Print
5/15/2020,$3.21,$0.00,$3537.48,Print
5/15/2020,$3.25,$0.00,$3540.69,Print
5/15/2020,$3.39,$0.00,$3543.94,Print
5/15/2020,$3.31,$0.00,$3547.33,Print
5/15/2020,$9.99,$0.00,$3550.64,Print
5/15/2020,$3.52,$0.00,$3560.63,Print
5/15/2020,$4.32,$0.00,$3564.15,Print
5/15/2020,$3.25,$0.00,$3568.47,Print
5/15/2020,$3.31,$0.00,$3571.72,Print
5/15/2020,$3.21,$0.00,$3575.03,Print
5/15/2020,$3.93,$0.00,$3578.24,Print
5/15/2020,$2.78,$0.00,$3582.17,Print
5/15/2020,$2.76,$0.00,$3584.95,Print
5/15/2020,$2.78,$0.00,$3587.71,Print
5/15/2020,$2.74,$0.00,$3590.49,Print
5/15/2020,$2.74,$0.00,$3593.23,Print
5/15/2020,$2.76,$0.00,$3595.97,Print
5/15/2020,$2.74,$0.00,$3598.73,Print
5/15/2020,$2.78,$0.00,$3601.47,Print
5/15/2020,$2.78,$0.00,$3604.25,Print
5/15/2020,$2.74,$0.00,$3607.03,Print
5/15/2020,$2.74,$0.00,$3609.77,Print
5/15/2020,$2.78,$0.00,$3612.51,Print
5/15/2020,$3.25,$0.00,$3615.29,Print
5/15/2020,$3.52,$0.00,$3618.54,Print
5/15/2020,$3.39,$0.00,$3622.06,Print
5/15/2020,$2.74,$0.00,$3625.45,Print
5/15/2020,$2.84,$0.00,$3628.19,Print
5/15/2020,$2.74,$0.00,$3631.03,Print
5/15/2020,$4.08,$0.00,$3633.77,Print
5/15/2020,$2.78,$0.00,$3637.85,Print
5/15/2020,$3.25,$0.00,$3640.63,Print
5/15/2020,$2.74,$0.00,$3643.88,Print
5/15/2020,$2.74,$0.00,$3646.62,Print
5/15/2020,$3.31,$0.00,$3649.36,Print
5/15/2020,$2.74,$0.00,$3652.67,Print
5/15/2020,$4.08,$0.00,$3655.41,Print
5/15/2020,$2.76,$0.00,$3659.49,Print
5/15/2020,$2.74,$0.00,$3662.25,Print
5/15/2020,$2.93,$0.00,$3664.99,Print
5/15/2020,$2.78,$0.00,$3667.92,Print
5/15/2020,$3.21,$0.00,$3670.70,Print
5/15/2020,$3.67,$0.00,$3673.91,Print
5/15/2020,$4.00,$0.00,$3677.58,Print
5/15/2020,$3.97,$0.00,$3681.58,Print
5/15/2020,$3.39,$0.00,$3685.55,Print
5/15/2020,$2.78,$0.00,$3688.94,Print
5/15/2020,$2.76,$0.00,$3691.72,Print
5/15/2020,$3.31,$0.00,$3694.48,Print
5/15/2020,$3.25,$0.00,$3697.79,Print
5/15/2020,$3.21,$0.00,$3701.04,Print
5/15/2020,$2.84,$0.00,$3704.25,Print
5/15/2020,$2.84,$0.00,$3707.09,Print
5/15/2020,$3.21,$0.00,$3709.93,Print
5/15/2020,$2.78,$0.00,$3713.14,Print
5/15/2020,$2.74,$0.00,$3715.92,Print
5/15/2020,$2.78,$0.00,$3718.66,Print
5/15/2020,$2.78,$0.00,$3721.44,Print
5/15/2020,$3.25,$0.00,$3724.22,Print
5/15/2020,$2.78,$0.00,$3727.47,Print
5/15/2020,$2.76,$0.00,$3730.25,Print
5/15/2020,$2.84,$0.00,$3733.01,Print
5/15/2020,$2.76,$0.00,$3735.85,Print
5/15/2020,$2.84,$0.00,$3738.61,Print
5/15/2020,$2.74,$0.00,$3741.45,Print
5/15/2020,$2.84,$0.00,$3744.19,Print
5/15/2020,$2.76,$0.00,$3747.03,Print
5/15/2020,$2.76,$0.00,$3749.79,Print
5/15/2020,$2.76,$0.00,$3752.55,Print
5/15/2020,$2.78,$0.00,$3755.31,Print
5/15/2020,$2.78,$0.00,$3758.09,Print
5/15/2020,$3.21,$0.00,$3760.87,Print
5/15/2020,$2.74,$0.00,$3764.08,Print
5/15/2020,$2.78,$0.00,$3766.82,Print
5/15/2020,$3.25,$0.00,$3769.60,Print
5/15/2020,$2.84,$0.00,$3772.85,Print
5/15/2020,$2.76,$0.00,$3775.69,Print
5/15/2020,$2.74,$0.00,$3778.45,Print
5/15/2020,$2.76,$0.00,$3781.19,Print
5/15/2020,$2.78,$0.00,$3783.95,Print
5/15/2020,$2.76,$0.00,$3786.73,Print
5/15/2020,$2.76,$0.00,$3789.49,Print
5/15/2020,$2.78,$0.00,$3792.25,Print
5/15/2020,$3.25,$0.00,$3795.03,Print
5/15/2020,$2.84,$0.00,$3798.28,Print
5/15/2020,$2.74,$0.00,$3801.12,Print
5/15/2020,$3.31,$0.00,$3803.86,Print
5/15/2020,$4.08,$0.00,$3807.17,Print
5/15/2020,$2.74,$0.00,$3811.25,Print
5/15/2020,$2.74,$0.00,$3813.99,Print
5/15/2020,$2.74,$0.00,$3816.73,Print
5/15/2020,$3.18,$0.00,$3819.47,Print
5/15/2020,$2.74,$0.00,$3822.65,Print
5/15/2020,$2.76,$0.00,$3825.39,Print
5/15/2020,$2.84,$0.00,$3828.15,Print
5/15/2020,$2.84,$0.00,$3830.99,Print
5/15/2020,$2.76,$0.00,$3833.83,Print
5/15/2020,$2.84,$0.00,$3836.59,Print
5/15/2020,$2.74,$0.00,$3839.43,Print
5/15/2020,$2.84,$0.00,$3842.17,Print
5/15/2020,$2.78,$0.00,$3845.01,Print
5/15/2020,$2.93,$0.00,$3847.79,Print
5/15/2020,$2.84,$0.00,$3850.72,Print
5/15/2020,$5.27,$0.00,$3853.56,Print
5/15/2020,$2.84,$0.00,$3858.83,Print
5/15/2020,$2.78,$0.00,$3861.67,Print
5/15/2020,$4.08,$0.00,$3864.45,Print
5/15/2020,$2.84,$0.00,$3868.53,Print
5/15/2020,$2.76,$0.00,$3871.37,Print
5/15/2020,$2.84,$0.00,$3874.13,Print
5/15/2020,$3.21,$0.00,$3876.97,Print
5/15/2020,$3.25,$0.00,$3880.18,Print
5/15/2020,$5.27,$0.00,$3883.43,Print
5/15/2020,$5.08,$0.00,$3888.70,Print
5/15/2020,$2.84,$0.00,$3893.78,Print
5/15/2020,$5.27,$0.00,$3896.62,Print
5/15/2020,$2.84,$0.00,$3901.89,Print
5/15/2020,$2.78,$0.00,$3904.73,Print
5/15/2020,$5.12,$0.00,$3907.51,Print
5/15/2020,$2.76,$0.00,$3912.63,Print
5/15/2020,$5.12,$0.00,$3915.39,Print
5/15/2020,$2.74,$0.00,$3920.51,Print
5/15/2020,$2.74,$0.00,$3923.25,Print
5/15/2020,$2.74,$0.00,$3925.99,Print
5/15/2020,$2.74,$0.00,$3928.73,Print
5/15/2020,$2.78,$0.00,$3931.47,Print
5/15/2020,$2.84,$0.00,$3934.25,Print
5/15/2020,$3.31,$0.00,$3937.09,Print
5/15/2020,$2.78,$0.00,$3940.40,Print
5/15/2020,$2.74,$0.00,$3943.18,Print
5/15/2020,$2.78,$0.00,$3945.92,Print
5/15/2020,$2.76,$0.00,$3948.70,Print
5/15/2020,$2.78,$0.00,$3951.46,Print
5/15/2020,$3.21,$0.00,$3954.24,Print
5/15/2020,$2.78,$0.00,$3957.45,Print
5/15/2020,$2.78,$0.00,$3960.23,Print
5/15/2020,$2.74,$0.00,$3963.01,Print
5/15/2020,$2.78,$0.00,$3965.75,Print
5/15/2020,$3.31,$0.00,$3968.53,Print
5/15/2020,$2.78,$0.00,$3971.84,Print
5/15/2020,$2.78,$0.00,$3974.62,Print
5/15/2020,$2.78,$0.00,$3977.40,Print
5/15/2020,$2.78,$0.00,$3980.18,Print
5/15/2020,$2.78,$0.00,$3982.96,Print
5/15/2020,$2.78,$0.00,$3985.74,Print
5/15/2020,$2.74,$0.00,$3988.52,Print
5/15/2020,$2.78,$0.00,$3991.26,Print
5/15/2020,$2.84,$0.00,$3994.04,Print
5/15/2020,$3.23,$0.00,$3996.88,Print
5/15/2020,$2.76,$0.00,$4000.11,Print
5/15/2020,$2.84,$0.00,$4002.87,Print
5/15/2020,$2.84,$0.00,$4005.71,Print
5/15/2020,$2.78,$0.00,$4008.55,Print
5/15/2020,$2.74,$0.00,$4011.33,Print
5/15/2020,$3.31,$0.00,$4014.07,Print
5/15/2020,$3.05,$0.00,$4017.38,Print
5/15/2020,$2.76,$0.00,$4020.43,Print
5/15/2020,$2.74,$0.00,$4023.19,Print
5/15/2020,$2.74,$0.00,$4025.93,Print
5/15/2020,$2.74,$0.00,$4028.67,Print
5/15/2020,$2.76,$0.00,$4031.41,Print
5/15/2020,$2.74,$0.00,$4034.17,Print
5/15/2020,$2.74,$0.00,$4036.91,Print
5/15/2020,$2.74,$0.00,$4039.65,Print
5/15/2020,$2.78,$0.00,$4042.39,Print
5/15/2020,$3.21,$0.00,$4045.17,Print
5/15/2020,$2.78,$0.00,$4048.38,Print
5/15/2020,$2.74,$0.00,$4051.16,Print
5/15/2020,$4.00,$0.00,$4053.90,Print
5/15/2020,$2.74,$0.00,$4057.90,Print
5/15/2020,$2.74,$0.00,$4060.64,Print
5/15/2020,$3.52,$0.00,$4063.38,Print
5/15/2020,$2.78,$0.00,$4066.90,Print
5/15/2020,$3.31,$0.00,$4069.68,Print
5/15/2020,$3.93,$0.00,$4072.99,Print
5/15/2020,$3.21,$0.00,$4076.92,Print
5/15/2020,$3.21,$0.00,$4080.13,Print
5/15/2020,$2.78,$0.00,$4083.34,Print
5/15/2020,$2.74,$0.00,$4086.12,Print
5/15/2020,$2.74,$0.00,$4088.86,Print
5/15/2020,$2.76,$0.00,$4091.60,Print
5/15/2020,$2.74,$0.00,$4094.36,Print
5/15/2020,$2.74,$0.00,$4097.10,Print
5/15/2020,$2.76,$0.00,$4099.84,Print
5/15/2020,$2.78,$0.00,$4102.60,Print
5/15/2020,$2.84,$0.00,$4105.38,Print
5/15/2020,$2.76,$0.00,$4108.22,Print
5/15/2020,$3.25,$0.00,$4110.98,Print
5/15/2020,$2.74,$0.00,$4114.23,Print
5/15/2020,$2.76,$0.00,$4116.97,Print
5/15/2020,$2.78,$0.00,$4119.73,Print
5/15/2020,$4.08,$0.00,$4122.51,Print
5/15/2020,$2.74,$0.00,$4126.59,Print
5/15/2020,$2.78,$0.00,$4129.33,Print
5/15/2020,$3.31,$0.00,$4132.11,Print
5/15/2020,$4.08,$0.00,$4135.42,Print
5/15/2020,$3.39,$0.00,$4139.50,Print
5/15/2020,$2.76,$0.00,$4142.89,Print
5/15/2020,$3.25,$0.00,$4145.65,Print
5/15/2020,$3.31,$0.00,$4148.90,Print
5/15/2020,$3.25,$0.00,$4152.21,Print
5/15/2020,$3.97,$0.00,$4155.46,Print
5/15/2020,$4.00,$0.00,$4159.43,Print
5/15/2020,$3.21,$0.00,$4163.43,Print
5/15/2020,$3.39,$0.00,$4166.64,Print
5/15/2020,$2.84,$0.00,$4170.03,Print
5/15/2020,$2.93,$0.00,$4172.87,Print
5/15/2020,$3.31,$0.00,$4175.80,Print
5/15/2020,$4.00,$0.00,$4179.11,Print
5/15/2020,$3.21,$0.00,$4183.11,Print
5/15/2020,$3.21,$0.00,$4186.32,Print
5/15/2020,$3.39,$0.00,$4189.53,Print
5/15/2020,$2.78,$0.00,$4192.92,Print
5/15/2020,$3.21,$0.00,$4195.70,Print
5/15/2020,$5.12,$0.00,$4198.91,Print
5/15/2020,$3.31,$0.00,$4204.03,Print
5/15/2020,$3.39,$0.00,$4207.34,Print
5/15/2020,$3.25,$0.00,$4210.73,Print
5/15/2020,$3.21,$0.00,$4213.98,Print
5/15/2020,$3.93,$0.00,$4217.19,Print
5/15/2020,$4.00,$0.00,$4221.12,Print
5/15/2020,$3.93,$0.00,$4225.12,Print
5/15/2020,$3.97,$0.00,$4229.05,Print
5/15/2020,$3.97,$0.00,$4233.02,Print
5/15/2020,$4.00,$0.00,$4236.99,Print
5/15/2020,$4.00,$0.00,$4240.99,Print
5/15/2020,$5.12,$0.00,$4244.99,Print
5/15/2020,$3.21,$0.00,$4250.11,Print
5/15/2020,$3.25,$0.00,$4253.32,Print
5/15/2020,$3.25,$0.00,$4256.57,Print
5/15/2020,$2.78,$0.00,$4259.82,Print
5/15/2020,$2.74,$0.00,$4262.60,Print
5/15/2020,$2.74,$0.00,$4265.34,Print
5/15/2020,$4.08,$0.00,$4268.08,Print
5/15/2020,$2.74,$0.00,$4272.16,Print
5/15/2020,$3.39,$0.00,$4274.90,Print
5/15/2020,$2.78,$0.00,$4278.29,Print
5/15/2020,$2.84,$0.00,$4281.07,Print
5/15/2020,$2.74,$0.00,$4283.91,Print
5/15/2020,$2.78,$0.00,$4286.65,Print
5/15/2020,$2.76,$0.00,$4289.43,Print
5/15/2020,$5.70,$0.00,$4292.19,Print
5/15/2020,$2.76,$0.00,$4297.89,Print
5/15/2020,$2.76,$0.00,$4300.65,Print
5/15/2020,$3.21,$0.00,$4303.41,Print
5/15/2020,$3.23,$0.00,$4306.62,Print
5/15/2020,$2.93,$0.00,$4309.85,Print
5/15/2020,$3.52,$0.00,$4312.78,Print
5/15/2020,$3.21,$0.00,$4316.30,Print
5/15/2020,$2.84,$0.00,$4319.51,Print
5/15/2020,$5.54,$0.00,$4322.35,Print
5/15/2020,$3.39,$0.00,$4327.89,Print
5/15/2020,$2.78,$0.00,$4331.28,Print
5/15/2020,$3.31,$0.00,$4334.06,Print
5/15/2020,$2.74,$0.00,$4337.37,Print
5/15/2020,$3.52,$0.00,$4340.11,Print
5/15/2020,$3.31,$0.00,$4343.63,Print
5/15/2020,$3.21,$0.00,$4346.94,Print
5/15/2020,$3.31,$0.00,$4350.15,Print
5/15/2020,$3.25,$0.00,$4353.46,Print
5/15/2020,$2.78,$0.00,$4356.71,Print
5/15/2020,$5.70,$0.00,$4359.49,Print
5/15/2020,$3.18,$0.00,$4365.19,Print
5/15/2020,$3.21,$0.00,$4368.37,Print
5/15/2020,$2.84,$0.00,$4371.58,Print
5/15/2020,$2.84,$0.00,$4374.42,Print
5/15/2020,$3.21,$0.00,$4377.26,Print
5/15/2020,$3.39,$0.00,$4380.47,Print
5/15/2020,$3.05,$0.00,$4383.86,Print
5/15/2020,$3.05,$0.00,$4386.91,Print
5/15/2020,$2.78,$0.00,$4389.96,Print
5/15/2020,$2.84,$0.00,$4392.74,Print
5/15/2020,$3.25,$0.00,$4395.58,Print
5/15/2020,$2.78,$0.00,$4398.83,Print
5/15/2020,$4.08,$0.00,$4401.61,Print
5/15/2020,$3.05,$0.00,$4405.69,Print
5/15/2020,$3.05,$0.00,$4408.74,Print
5/15/2020,$3.31,$0.00,$4411.79,Print
5/15/2020,$2.84,$0.00,$4415.10,Print
5/15/2020,$3.25,$0.00,$4417.94,Print
5/15/2020,$2.74,$0.00,$4421.19,Print
5/15/2020,$2.78,$0.00,$4423.93,Print
5/15/2020,$2.78,$0.00,$4426.71,Print
5/15/2020,$4.00,$0.00,$4429.49,Print
5/15/2020,$3.21,$0.00,$4433.49,Print
5/15/2020,$2.74,$0.00,$4436.70,Print
5/15/2020,$3.25,$0.00,$4439.44,Print
5/15/2020,$3.25,$0.00,$4442.69,Print
5/15/2020,$2.78,$0.00,$4445.94,Print
5/15/2020,$4.46,$0.00,$4448.72,Print
5/15/2020,$2.74,$0.00,$4453.18,Print
5/15/2020,$4.00,$0.00,$4455.92,Print
5/15/2020,$3.05,$0.00,$4459.92,Print
5/15/2020,$3.31,$0.00,$4462.97,Print
5/15/2020,$2.78,$0.00,$4466.28,Print
5/15/2020,$3.39,$0.00,$4469.06,Print
5/15/2020,$2.78,$0.00,$4472.45,Print
5/15/2020,$3.31,$0.00,$4475.23,Print
5/15/2020,$3.25,$0.00,$4478.54,Print
5/15/2020,$3.31,$0.00,$4481.79,Print
5/15/2020,$2.76,$0.00,$4485.10,Print
5/15/2020,$2.84,$0.00,$4487.86,Print
5/15/2020,$2.78,$0.00,$4490.70,Print
5/15/2020,$2.78,$0.00,$4493.48,Print
5/15/2020,$2.76,$0.00,$4496.26,Print
5/15/2020,$2000.00,$0.00,$4499.02,Purchase
5/15/2020,$2.84,$0.00,$2499.02,Print
5/15/2020,$2.78,$0.00,$2501.86,Print
5/15/2020,$3.25,$0.00,$2504.64,Print
5/15/2020,$4.32,$0.00,$2507.89,Print
5/15/2020,$4.08,$0.00,$2512.21,Print
5/15/2020,$3.25,$0.00,$2516.29,Print
5/15/2020,$4.32,$0.00,$2519.54,Print
5/15/2020,$3.31,$0.00,$2523.86,Print
5/15/2020,$3.05,$0.00,$2527.17,Print
5/15/2020,$2.78,$0.00,$2530.22,Print
5/15/2020,$2.84,$0.00,$2533.00,Print
5/15/2020,$3.25,$0.00,$2535.84,Print
5/15/2020,$2.76,$0.00,$2539.09,Print
5/15/2020,$2.76,$0.00,$2541.85,Print
5/15/2020,$2.74,$0.00,$2544.61,Print
5/15/2020,$2.84,$0.00,$2547.35,Print
5/15/2020,$3.23,$0.00,$2550.19,Print
5/15/2020,$2.84,$0.00,$2553.42,Print
5/15/2020,$3.31,$0.00,$2556.26,Print
5/15/2020,$3.21,$0.00,$2559.57,Print
5/15/2020,$2.93,$0.00,$2562.78,Print
5/15/2020,$2.76,$0.00,$2565.71,Print
5/15/2020,$2.78,$0.00,$2568.47,Print
5/15/2020,$2.74,$0.00,$2571.25,Print
5/15/2020,$3.31,$0.00,$2573.99,Print
5/15/2020,$2.76,$0.00,$2577.30,Print
5/15/2020,$3.31,$0.00,$2580.06,Print
5/15/2020,$3.21,$0.00,$2583.37,Print
5/15/2020,$2.78,$0.00,$2586.58,Print
5/15/2020,$2.74,$0.00,$2589.36,Print
5/15/2020,$3.05,$0.00,$2592.10,Print
5/15/2020,$3.52,$0.00,$2595.15,Print
5/15/2020,$3.31,$0.00,$2598.67,Print
5/15/2020,$3.52,$0.00,$2601.98,Print
5/15/2020,$20.62,$0.00,$2605.50,Print
5/15/2020,$3.31,$0.00,$2626.12,Print
5/15/2020,$3.25,$0.00,$2629.43,Print
5/15/2020,$4.00,$0.00,$2632.68,Print
5/15/2020,$2.84,$0.00,$2636.68,Print
5/15/2020,$3.31,$0.00,$2639.52,Print
5/15/2020,$28.08,$0.00,$2642.83,Print
5/15/2020,$2.84,$0.00,$2670.91,Print
5/15/2020,$2.78,$0.00,$2673.75,Print
5/15/2020,$3.31,$0.00,$2676.53,Print
5/15/2020,$3.05,$0.00,$2679.84,Print
5/15/2020,$3.21,$0.00,$2682.89,Print
5/15/2020,$3.25,$0.00,$2686.10,Print
5/15/2020,$2.78,$0.00,$2689.35,Print
5/15/2020,$3.52,$0.00,$2692.13,Print
5/15/2020,$3.21,$0.00,$2695.65,Print
5/15/2020,$2.76,$0.00,$2698.86,Print
5/15/2020,$3.31,$0.00,$2701.62,Print
5/15/2020,$2.74,$0.00,$2704.93,Print
5/15/2020,$2.76,$0.00,$2707.67,Print
5/15/2020,$2.74,$0.00,$2710.43,Print
5/15/2020,$2.74,$0.00,$2713.17,Print
5/15/2020,$3.25,$0.00,$2715.91,Print
5/15/2020,$2.74,$0.00,$2719.16,Print
5/15/2020,$3.31,$0.00,$2721.90,Print
5/15/2020,$2.74,$0.00,$2725.21,Print
5/15/2020,$2.74,$0.00,$2727.95,Print
5/15/2020,$3.25,$0.00,$2730.69,Print
5/15/2020,$2.78,$0.00,$2733.94,Print
5/15/2020,$2.84,$0.00,$2736.72,Print
5/15/2020,$2.76,$0.00,$2739.56,Print
5/15/2020,$2.84,$0.00,$2742.32,Print
5/15/2020,$2.84,$0.00,$2745.16,Print
5/15/2020,$2.74,$0.00,$2748.00,Print
5/15/2020,$4.32,$0.00,$2750.74,Print
5/15/2020,$3.93,$0.00,$2755.06,Print
5/15/2020,$2.78,$0.00,$2758.99,Print
5/15/2020,$2.76,$0.00,$2761.77,Print
5/15/2020,$4.00,$0.00,$2764.53,Print
5/15/2020,$2.74,$0.00,$2768.53,Print
5/15/2020,$3.05,$0.00,$2771.27,Print
5/15/2020,$2.74,$0.00,$2774.32,Print
5/15/2020,$2.93,$0.00,$2777.06,Print
5/15/2020,$2.84,$0.00,$2779.99,Print
5/15/2020,$3.23,$0.00,$2782.83,Print
5/15/2020,$3.52,$0.00,$2786.06,Print
5/15/2020,$2.76,$0.00,$2789.58,Print
5/15/2020,$3.25,$0.00,$2792.34,Print
5/15/2020,$2.76,$0.00,$2795.59,Print
5/15/2020,$3.39,$0.00,$2798.35,Print
5/15/2020,$3.31,$0.00,$2801.74,Print
5/15/2020,$2.78,$0.00,$2805.05,Print
5/15/2020,$2.76,$0.00,$2807.83,Print
5/15/2020,$2.78,$0.00,$2810.59,Print
5/15/2020,$3.21,$0.00,$2813.37,Print
5/15/2020,$2.93,$0.00,$2816.58,Print
5/15/2020,$3.25,$0.00,$2819.51,Print
5/15/2020,$3.25,$0.00,$2822.76,Print
5/15/2020,$3.25,$0.00,$2826.01,Print
5/15/2020,$5.08,$0.00,$2829.26,Print
5/15/2020,$2.76,$0.00,$2834.34,Print
5/15/2020,$2.74,$0.00,$2837.10,Print
5/15/2020,$2.76,$0.00,$2839.84,Print
5/15/2020,$2.74,$0.00,$2842.60,Print
5/15/2020,$2.74,$0.00,$2845.34,Print
5/15/2020,$3.25,$0.00,$2848.08,Print
5/15/2020,$2.78,$0.00,$2851.33,Print
5/15/2020,$3.31,$0.00,$2854.11,Print
5/15/2020,$5.04,$0.00,$2857.42,Print
5/15/2020,$3.31,$0.00,$2862.46,Print
5/15/2020,$3.25,$0.00,$2865.77,Print
5/15/2020,$3.23,$0.00,$2869.02,Print
5/15/2020,$2.93,$0.00,$2872.25,Print
5/15/2020,$2.78,$0.00,$2875.18,Print
5/15/2020,$2.84,$0.00,$2877.96,Print
5/15/2020,$2.78,$0.00,$2880.80,Print
5/15/2020,$3.31,$0.00,$2883.58,Print
5/15/2020,$2.76,$0.00,$2886.89,Print
5/15/2020,$3.97,$0.00,$2889.65,Print
5/15/2020,$2.78,$0.00,$2893.62,Print
5/15/2020,$3.31,$0.00,$2896.40,Print
5/15/2020,$3.31,$0.00,$2899.71,Print
5/15/2020,$2.84,$0.00,$2903.02,Print
5/15/2020,$2.84,$0.00,$2905.86,Print
5/15/2020,$2.84,$0.00,$2908.70,Print
5/15/2020,$3.21,$0.00,$2911.54,Print
5/15/2020,$2.78,$0.00,$2914.75,Print
5/15/2020,$2.74,$0.00,$2917.53,Print
5/15/2020,$2.84,$0.00,$2920.27,Print
5/15/2020,$2.78,$0.00,$2923.11,Print
5/15/2020,$3.25,$0.00,$2925.89,Print
5/15/2020,$2.84,$0.00,$2929.14,Print
5/15/2020,$2.84,$0.00,$2931.98,Print
5/15/2020,$3.25,$0.00,$2934.82,Print
5/15/2020,$2.78,$0.00,$2938.07,Print
5/15/2020,$2.84,$0.00,$2940.85,Print
5/15/2020,$2.84,$0.00,$2943.69,Print
5/15/2020,$2.84,$0.00,$2946.53,Print
5/15/2020,$2.84,$0.00,$2949.37,Print
5/15/2020,$2.84,$0.00,$2952.21,Print
5/15/2020,$2.76,$0.00,$2955.05,Print
5/15/2020,$2.84,$0.00,$2957.81,Print
5/15/2020,$2.84,$0.00,$2960.65,Print
5/15/2020,$2.76,$0.00,$2963.49,Print
5/15/2020,$2.84,$0.00,$2966.25,Print
5/15/2020,$2.84,$0.00,$2969.09,Print
5/15/2020,$3.31,$0.00,$2971.93,Print
5/15/2020,$2.84,$0.00,$2975.24,Print
5/15/2020,$2.78,$0.00,$2978.08,Print
5/15/2020,$2.93,$0.00,$2980.86,Print
5/15/2020,$3.21,$0.00,$2983.79,Print
5/15/2020,$2.76,$0.00,$2987.00,Print
5/15/2020,$5.04,$0.00,$2989.76,Print
5/15/2020,$2.74,$0.00,$2994.80,Print
5/15/2020,$2.76,$0.00,$2997.54,Print
5/15/2020,$3.05,$0.00,$3000.30,Print
5/15/2020,$2.78,$0.00,$3003.35,Print
5/15/2020,$2.78,$0.00,$3006.13,Print
5/15/2020,$8.42,$0.00,$3008.91,Print
5/15/2020,$2.93,$0.00,$3017.33,Print
5/15/2020,$3.31,$0.00,$3020.26,Print
5/15/2020,$3.31,$0.00,$3023.57,Print
5/15/2020,$2.84,$0.00,$3026.88,Print
5/15/2020,$2.78,$0.00,$3029.72,Print
5/15/2020,$3.25,$0.00,$3032.50,Print
5/15/2020,$2.78,$0.00,$3035.75,Print
5/15/2020,$3.31,$0.00,$3038.53,Print
5/15/2020,$3.31,$0.00,$3041.84,Print
5/15/2020,$3.25,$0.00,$3045.15,Print
5/15/2020,$3.31,$0.00,$3048.40,Print
5/15/2020,$3.31,$0.00,$3051.71,Print
5/15/2020,$3.25,$0.00,$3055.02,Print
5/15/2020,$2.84,$0.00,$3058.27,Print
5/15/2020,$2.84,$0.00,$3061.11,Print
5/15/2020,$2.84,$0.00,$3063.95,Print
5/15/2020,$3.31,$0.00,$3066.79,Print
5/15/2020,$2.84,$0.00,$3070.10,Print
5/15/2020,$2.78,$0.00,$3072.94,Print
5/15/2020,$2.84,$0.00,$3075.72,Print
5/15/2020,$2.76,$0.00,$3078.56,Print
5/15/2020,$3.25,$0.00,$3081.32,Print
5/15/2020,$3.25,$0.00,$3084.57,Print
5/15/2020,$2.84,$0.00,$3087.82,Print
5/15/2020,$2.84,$0.00,$3090.66,Print
5/15/2020,$2.84,$0.00,$3093.50,Print
5/15/2020,$2.78,$0.00,$3096.34,Print
5/15/2020,$2.78,$0.00,$3099.12,Print
5/15/2020,$4.00,$0.00,$3101.90,Print
5/15/2020,$2.84,$0.00,$3105.90,Print
5/15/2020,$3.25,$0.00,$3108.74,Print
5/15/2020,$2.84,$0.00,$3111.99,Print
5/15/2020,$2.78,$0.00,$3114.83,Print
5/15/2020,$3.25,$0.00,$3117.61,Print
5/15/2020,$3.21,$0.00,$3120.86,Print
5/15/2020,$3.23,$0.00,$3124.07,Print
5/15/2020,$3.25,$0.00,$3127.30,Print
5/15/2020,$3.25,$0.00,$3130.55,Print
5/15/2020,$3.31,$0.00,$3133.80,Print
5/15/2020,$2.78,$0.00,$3137.11,Print
5/15/2020,$3.25,$0.00,$3139.89,Print
5/15/2020,$3.25,$0.00,$3143.14,Print
5/15/2020,$2.84,$0.00,$3146.39,Print
5/15/2020,$3.31,$0.00,$3149.23,Print
5/15/2020,$2.76,$0.00,$3152.54,Print
5/15/2020,$2.93,$0.00,$3155.30,Print
5/15/2020,$2.84,$0.00,$3158.23,Print
5/15/2020,$3.25,$0.00,$3161.07,Print
5/15/2020,$3.52,$0.00,$3164.32,Print
5/15/2020,$2.78,$0.00,$3167.84,Print
5/15/2020,$2.78,$0.00,$3170.62,Print
5/15/2020,$2.84,$0.00,$3173.40,Print
5/15/2020,$3.23,$0.00,$3176.24,Print
5/15/2020,$2.78,$0.00,$3179.47,Print
5/15/2020,$2.84,$0.00,$3182.25,Print
5/15/2020,$2.84,$0.00,$3185.09,Print
5/15/2020,$3.31,$0.00,$3187.93,Print
5/15/2020,$3.25,$0.00,$3191.24,Print
5/15/2020,$3.31,$0.00,$3194.49,Print
5/15/2020,$2.74,$0.00,$3197.80,Print
5/15/2020,$2.84,$0.00,$3200.54,Print
5/15/2020,$2.76,$0.00,$3203.38,Print
5/14/2020,$2.84,$0.00,$3206.14,Print
5/14/2020,$2.84,$0.00,$3208.98,Print
5/14/2020,$3.21,$0.00,$3211.82,Print
5/14/2020,$2.84,$0.00,$3215.03,Print
5/14/2020,$2.74,$0.00,$3217.87,Print
5/14/2020,$2.93,$0.00,$3220.61,Print
5/14/2020,$2.78,$0.00,$3223.54,Print
5/14/2020,$2.84,$0.00,$3226.32,Print
5/14/2020,$2.76,$0.00,$3229.16,Print
5/14/2020,$2.78,$0.00,$3231.92,Print
5/14/2020,$2.78,$0.00,$3234.70,Print
5/14/2020,$20.46,$0.00,$3237.48,Print
5/14/2020,$2.84,$0.00,$3257.94,Print
5/14/2020,$2.78,$0.00,$3260.78,Print
5/14/2020,$2.78,$0.00,$3263.56,Print
5/14/2020,$2.76,$0.00,$3266.34,Print
5/14/2020,$2.84,$0.00,$3269.10,Print
5/14/2020,$2.78,$0.00,$3271.94,Print
5/14/2020,$3.25,$0.00,$3274.72,Print
5/14/2020,$3.25,$0.00,$3277.97,Print
5/14/2020,$2.84,$0.00,$3281.22,Print
5/14/2020,$2.84,$0.00,$3284.06,Print
5/14/2020,$2.84,$0.00,$3286.90,Print
5/14/2020,$2.76,$0.00,$3289.74,Print
5/14/2020,$3.25,$0.00,$3292.50,Print
5/14/2020,$2.93,$0.00,$3295.75,Print
5/14/2020,$2.76,$0.00,$3298.68,Print
5/14/2020,$2.78,$0.00,$3301.44,Print
5/14/2020,$3.39,$0.00,$3304.22,Print
5/14/2020,$2.78,$0.00,$3307.61,Print
5/14/2020,$2.78,$0.00,$3310.39,Print
5/14/2020,$2.74,$0.00,$3313.17,Print
5/14/2020,$2.78,$0.00,$3315.91,Print
5/14/2020,$2.78,$0.00,$3318.69,Print
5/14/2020,$4.08,$0.00,$3321.47,Print
5/14/2020,$3.21,$0.00,$3325.55,Print
5/14/2020,$3.21,$0.00,$3328.76,Print
5/14/2020,$2.76,$0.00,$3331.97,Print
5/14/2020,$2.74,$0.00,$3334.73,Print
5/14/2020,$2.93,$0.00,$3337.47,Print
5/14/2020,$3.21,$0.00,$3340.40,Print
5/14/2020,$3.31,$0.00,$3343.61,Print
5/14/2020,$2.76,$0.00,$3346.92,Print
5/14/2020,$2.76,$0.00,$3349.68,Print
5/14/2020,$3.23,$0.00,$3352.44,Print
5/14/2020,$2.78,$0.00,$3355.67,Print
5/14/2020,$3.25,$0.00,$3358.45,Print
5/14/2020,$2.76,$0.00,$3361.70,Print
5/14/2020,$2.84,$0.00,$3364.46,Print
5/14/2020,$2.74,$0.00,$3367.30,Print
5/14/2020,$5.12,$0.00,$3370.04,Print
5/14/2020,$2.74,$0.00,$3375.16,Print
5/14/2020,$2.76,$0.00,$3377.90,Print
5/14/2020,$2.74,$0.00,$3380.66,Print
5/14/2020,$2.78,$0.00,$3383.40,Print
5/14/2020,$2.74,$0.00,$3386.18,Print
5/14/2020,$3.21,$0.00,$3388.92,Print
5/14/2020,$3.52,$0.00,$3392.13,Print
5/14/2020,$2.78,$0.00,$3395.65,Print
5/14/2020,$3.31,$0.00,$3398.43,Print
5/14/2020,$2.78,$0.00,$3401.74,Print
5/14/2020,$2.74,$0.00,$3404.52,Print
5/14/2020,$3.23,$0.00,$3407.26,Print
5/14/2020,$2.74,$0.00,$3410.49,Print
5/14/2020,$2.76,$0.00,$3413.23,Print
5/14/2020,$2.84,$0.00,$3415.99,Print
5/14/2020,$2.74,$0.00,$3418.83,Print
5/14/2020,$2.74,$0.00,$3421.57,Print
5/14/2020,$3.23,$0.00,$3424.31,Print
5/14/2020,$3.25,$0.00,$3427.54,Print
5/14/2020,$2.84,$0.00,$3430.79,Print
5/14/2020,$2.74,$0.00,$3433.63,Print
5/14/2020,$2.78,$0.00,$3436.37,Print
5/14/2020,$2.74,$0.00,$3439.15,Print
5/14/2020,$3.21,$0.00,$3441.89,Print
5/14/2020,$2.76,$0.00,$3445.10,Print
5/14/2020,$3.21,$0.00,$3447.86,Print
5/14/2020,$2.76,$0.00,$3451.07,Print
5/14/2020,$2.76,$0.00,$3453.83,Print
5/14/2020,$3.31,$0.00,$3456.59,Print
5/14/2020,$2.78,$0.00,$3459.90,Print
5/14/2020,$2.74,$0.00,$3462.68,Print
5/14/2020,$3.25,$0.00,$3465.42,Print
5/14/2020,$2.84,$0.00,$3468.67,Print
5/14/2020,$3.25,$0.00,$3471.51,Print
5/14/2020,$3.52,$0.00,$3474.76,Print
5/14/2020,$3.52,$0.00,$3478.28,Print
5/14/2020,$3.05,$0.00,$3481.80,Print
5/14/2020,$2.74,$0.00,$3484.85,Print
5/14/2020,$2.78,$0.00,$3487.59,Print
5/14/2020,$2.78,$0.00,$3490.37,Print
5/14/2020,$2.74,$0.00,$3493.15,Print
5/14/2020,$2.78,$0.00,$3495.89,Print
5/14/2020,$4.00,$0.00,$3498.67,Print
5/14/2020,$2.74,$0.00,$3502.67,Print
5/14/2020,$2.84,$0.00,$3505.41,Print
5/14/2020,$3.25,$0.00,$3508.25,Print
5/14/2020,$3.25,$0.00,$3511.50,Print
5/14/2020,$2.84,$0.00,$3514.75,Print
5/14/2020,$2.76,$0.00,$3517.59,Print
5/14/2020,$2.84,$0.00,$3520.35,Print
5/14/2020,$3.21,$0.00,$3523.19,Print
5/14/2020,$2.74,$0.00,$3526.40,Print
5/14/2020,$2.78,$0.00,$3529.14,Print
5/14/2020,$2.78,$0.00,$3531.92,Print
5/14/2020,$2.78,$0.00,$3534.70,Print
5/14/2020,$2.78,$0.00,$3537.48,Print
5/14/2020,$2.78,$0.00,$3540.26,Print
5/14/2020,$2.84,$0.00,$3543.04,Print
5/14/2020,$2.78,$0.00,$3545.88,Print
5/14/2020,$2.84,$0.00,$3548.66,Print
5/14/2020,$2.78,$0.00,$3551.50,Print
5/14/2020,$2.74,$0.00,$3554.28,Print
5/14/2020,$2.78,$0.00,$3557.02,Print
5/14/2020,$2.76,$0.00,$3559.80,Print
5/14/2020,$2.78,$0.00,$3562.56,Print
5/14/2020,$3.25,$0.00,$3565.34,Print
5/14/2020,$2.78,$0.00,$3568.59,Print
5/14/2020,$3.25,$0.00,$3571.37,Print
5/14/2020,$2.84,$0.00,$3574.62,Print
5/14/2020,$2.84,$0.00,$3577.46,Print
5/14/2020,$2.76,$0.00,$3580.30,Print
5/14/2020,$3.21,$0.00,$3583.06,Print
5/14/2020,$4.08,$0.00,$3586.27,Print
5/14/2020,$5.04,$0.00,$3590.35,Print
5/14/2020,$2.74,$0.00,$3595.39,Print
5/14/2020,$3.25,$0.00,$3598.13,Print
5/14/2020,$3.21,$0.00,$3601.38,Print
5/14/2020,$3.25,$0.00,$3604.59,Print
5/14/2020,$2.84,$0.00,$3607.84,Print
5/14/2020,$3.23,$0.00,$3610.68,Print
5/14/2020,$2.74,$0.00,$3613.91,Print
5/14/2020,$2.74,$0.00,$3616.65,Print
5/14/2020,$2.78,$0.00,$3619.39,Print
5/14/2020,$3.23,$0.00,$3622.17,Print
5/14/2020,$2.74,$0.00,$3625.40,Print
5/14/2020,$3.21,$0.00,$3628.14,Print
5/14/2020,$2.78,$0.00,$3631.35,Print
5/14/2020,$4.08,$0.00,$3634.13,Print
5/14/2020,$3.93,$0.00,$3638.21,Print
5/14/2020,$3.23,$0.00,$3642.14,Print
5/14/2020,$2.84,$0.00,$3645.37,Print
5/14/2020,$2.84,$0.00,$3648.21,Print
5/14/2020,$2.78,$0.00,$3651.05,Print
5/14/2020,$2.78,$0.00,$3653.83,Print
5/14/2020,$5.12,$0.00,$3656.61,Print
5/14/2020,$5.08,$0.00,$3661.73,Print
5/14/2020,$5.04,$0.00,$3666.81,Print
5/14/2020,$3.21,$0.00,$3671.85,Print
5/14/2020,$7.84,$0.00,$3675.06,Print
5/14/2020,$2.84,$0.00,$3682.90,Print
5/14/2020,$2.78,$0.00,$3685.74,Print
5/14/2020,$2.74,$0.00,$3688.52,Print
5/14/2020,$7.64,$0.00,$3691.26,Print
5/14/2020,$5.70,$0.00,$3698.90,Print
5/14/2020,$3.93,$0.00,$3704.60,Print
5/14/2020,$2.78,$0.00,$3708.53,Print
5/14/2020,$2.84,$0.00,$3711.31,Print
5/14/2020,$3.31,$0.00,$3714.15,Print
5/14/2020,$3.93,$0.00,$3717.46,Print
5/14/2020,$3.25,$0.00,$3721.39,Print
5/14/2020,$3.25,$0.00,$3724.64,Print
5/14/2020,$3.23,$0.00,$3727.89,Print
5/14/2020,$3.25,$0.00,$3731.12,Print
5/14/2020,$3.25,$0.00,$3734.37,Print
5/14/2020,$2.78,$0.00,$3737.62,Print
5/14/2020,$3.31,$0.00,$3740.40,Print
5/14/2020,$3.31,$0.00,$3743.71,Print
5/14/2020,$3.25,$0.00,$3747.02,Print
5/14/2020,$3.39,$0.00,$3750.27,Print
5/14/2020,$4.00,$0.00,$3753.66,Print
5/14/2020,$3.25,$0.00,$3757.66,Print
5/14/2020,$3.25,$0.00,$3760.91,Print
5/14/2020,$2.76,$0.00,$3764.16,Print
5/14/2020,$3.23,$0.00,$3766.92,Print
5/14/2020,$2.76,$0.00,$3770.15,Print
5/14/2020,$3.21,$0.00,$3772.91,Print
5/14/2020,$2.84,$0.00,$3776.12,Print
5/14/2020,$3.23,$0.00,$3778.96,Print
5/14/2020,$3.25,$0.00,$3782.19,Print
5/14/2020,$2.76,$0.00,$3785.44,Print
5/14/2020,$2.84,$0.00,$3788.20,Print
5/14/2020,$2.74,$0.00,$3791.04,Print
5/14/2020,$2.78,$0.00,$3793.78,Print
5/14/2020,$3.25,$0.00,$3796.56,Print
5/14/2020,$3.25,$0.00,$3799.81,Print
5/14/2020,$2.78,$0.00,$3803.06,Print
5/14/2020,$2.76,$0.00,$3805.84,Print
5/14/2020,$2.76,$0.00,$3808.60,Print
5/14/2020,$2.78,$0.00,$3811.36,Print
5/14/2020,$2.78,$0.00,$3814.14,Print
5/14/2020,$2.76,$0.00,$3816.92,Print
5/14/2020,$3.25,$0.00,$3819.68,Print
5/14/2020,$3.21,$0.00,$3822.93,Print
5/14/2020,$2.78,$0.00,$3826.14,Print
5/14/2020,$2.84,$0.00,$3828.92,Print
5/14/2020,$3.25,$0.00,$3831.76,Print
5/14/2020,$8.12,$0.00,$3835.01,Print
5/14/2020,$3.21,$0.00,$3843.13,Print
5/14/2020,$2.76,$0.00,$3846.34,Print
5/14/2020,$2.78,$0.00,$3849.10,Print
5/14/2020,$4.08,$0.00,$3851.88,Print
5/14/2020,$2.84,$0.00,$3855.96,Print
5/14/2020,$2.76,$0.00,$3858.80,Print
5/14/2020,$2.84,$0.00,$3861.56,Print
5/14/2020,$2.84,$0.00,$3864.40,Print
5/14/2020,$2.78,$0.00,$3867.24,Print
5/14/2020,$2.84,$0.00,$3870.02,Print
5/14/2020,$2.84,$0.00,$3872.86,Print
5/14/2020,$2.84,$0.00,$3875.70,Print
5/14/2020,$2.76,$0.00,$3878.54,Print
5/14/2020,$3.25,$0.00,$3881.30,Print
5/14/2020,$3.21,$0.00,$3884.55,Print
5/14/2020,$2.74,$0.00,$3887.76,Print
5/14/2020,$7.56,$0.00,$3890.50,Print
5/14/2020,$3.21,$0.00,$3898.06,Print
5/14/2020,$3.31,$0.00,$3901.27,Print
5/14/2020,$2.84,$0.00,$3904.58,Print
5/14/2020,$2.74,$0.00,$3907.42,Print
5/14/2020,$2.78,$0.00,$3910.16,Print
5/14/2020,$3.31,$0.00,$3912.94,Print
5/14/2020,$2.76,$0.00,$3916.25,Print
5/14/2020,$2.74,$0.00,$3919.01,Print
5/14/2020,$2.78,$0.00,$3921.75,Print
5/14/2020,$3.23,$0.00,$3924.53,Print
5/14/2020,$2.84,$0.00,$3927.76,Print
5/14/2020,$2.84,$0.00,$3930.60,Print
5/14/2020,$2.84,$0.00,$3933.44,Print
5/14/2020,$2.84,$0.00,$3936.28,Print
5/14/2020,$2.78,$0.00,$3939.12,Print
5/14/2020,$2.78,$0.00,$3941.90,Print
5/14/2020,$3.52,$0.00,$3944.68,Print
5/14/2020,$2.84,$0.00,$3948.20,Print
5/14/2020,$2.76,$0.00,$3951.04,Print
5/14/2020,$2.84,$0.00,$3953.80,Print
5/14/2020,$2.84,$0.00,$3956.64,Print
5/14/2020,$2.76,$0.00,$3959.48,Print
5/14/2020,$2.78,$0.00,$3962.24,Print
5/14/2020,$2.78,$0.00,$3965.02,Print
5/14/2020,$2.84,$0.00,$3967.80,Print
5/14/2020,$2.84,$0.00,$3970.64,Print
5/14/2020,$2.84,$0.00,$3973.48,Print
5/14/2020,$2.84,$0.00,$3976.32,Print
5/14/2020,$3.25,$0.00,$3979.16,Print
5/14/2020,$2.76,$0.00,$3982.41,Print
5/14/2020,$2.74,$0.00,$3985.17,Print
5/14/2020,$2.78,$0.00,$3987.91,Print
5/14/2020,$3.23,$0.00,$3990.69,Print
5/14/2020,$3.25,$0.00,$3993.92,Print
5/14/2020,$2.76,$0.00,$3997.17,Print
5/14/2020,$2.84,$0.00,$3999.93,Print
5/14/2020,$2.74,$0.00,$4002.77,Print
5/14/2020,$2.84,$0.00,$4005.51,Print
5/14/2020,$2.76,$0.00,$4008.35,Print
5/14/2020,$3.25,$0.00,$4011.11,Print
5/14/2020,$3.25,$0.00,$4014.36,Print
5/14/2020,$2.76,$0.00,$4017.61,Print
5/14/2020,$2.74,$0.00,$4020.37,Print
5/14/2020,$2.74,$0.00,$4023.11,Print
5/14/2020,$2.76,$0.00,$4025.85,Print
5/14/2020,$2.74,$0.00,$4028.61,Print
5/14/2020,$3.25,$0.00,$4031.35,Print
5/14/2020,$2.76,$0.00,$4034.60,Print
5/14/2020,$3.23,$0.00,$4037.36,Print
5/14/2020,$2.78,$0.00,$4040.59,Print
5/14/2020,$3.21,$0.00,$4043.37,Print
5/14/2020,$2.84,$0.00,$4046.58,Print
5/14/2020,$2.76,$0.00,$4049.42,Print
5/14/2020,$2.78,$0.00,$4052.18,Print
5/14/2020,$3.25,$0.00,$4054.96,Print
5/14/2020,$2.84,$0.00,$4058.21,Print
5/14/2020,$2.84,$0.00,$4061.05,Print
5/14/2020,$2.84,$0.00,$4063.89,Print
5/14/2020,$2.78,$0.00,$4066.73,Print
5/14/2020,$2.84,$0.00,$4069.51,Print
5/14/2020,$2.93,$0.00,$4072.35,Print
5/14/2020,$3.52,$0.00,$4075.28,Print
5/14/2020,$3.39,$0.00,$4078.80,Print
5/14/2020,$3.31,$0.00,$4082.19,Print
5/14/2020,$3.25,$0.00,$4085.50,Print
5/14/2020,$3.31,$0.00,$4088.75,Print
5/14/2020,$3.21,$0.00,$4092.06,Print
5/14/2020,$3.67,$0.00,$4095.27,Print
5/14/2020,$3.67,$0.00,$4098.94,Print
5/14/2020,$8.04,$0.00,$4102.61,Print
5/14/2020,$3.31,$0.00,$4110.65,Print
5/14/2020,$3.21,$0.00,$4113.96,Print
5/14/2020,$3.25,$0.00,$4117.17,Print
5/14/2020,$3.25,$0.00,$4120.42,Print
5/14/2020,$3.25,$0.00,$4123.67,Print
5/14/2020,$3.21,$0.00,$4126.92,Print
5/14/2020,$3.25,$0.00,$4130.13,Print
5/14/2020,$3.21,$0.00,$4133.38,Print
5/14/2020,$3.21,$0.00,$4136.59,Print
5/14/2020,$3.25,$0.00,$4139.80,Print
5/14/2020,$3.25,$0.00,$4143.05,Print
5/14/2020,$2.74,$0.00,$4146.30,Print
5/14/2020,$2.84,$0.00,$4149.04,Print
5/14/2020,$2.78,$0.00,$4151.88,Print
5/14/2020,$2.76,$0.00,$4154.66,Print
5/14/2020,$2.84,$0.00,$4157.42,Print
5/14/2020,$2.78,$0.00,$4160.26,Print
5/14/2020,$2.84,$0.00,$4163.04,Print
5/14/2020,$4.00,$0.00,$4165.88,Print
5/14/2020,$3.97,$0.00,$4169.88,Print
5/14/2020,$3.25,$0.00,$4173.85,Print
5/14/2020,$2.84,$0.00,$4177.10,Print
5/14/2020,$2.78,$0.00,$4179.94,Print
5/14/2020,$2.84,$0.00,$4182.72,Print
5/14/2020,$2.78,$0.00,$4185.56,Print
5/14/2020,$2.78,$0.00,$4188.34,Print
5/14/2020,$5.04,$0.00,$4191.12,Print
5/14/2020,$8.59,$0.00,$4196.16,Print
5/14/2020,$5.12,$0.00,$4204.75,Print
5/14/2020,$3.93,$0.00,$4209.87,Print
5/14/2020,$3.93,$0.00,$4213.80,Print
5/14/2020,$4.00,$0.00,$4217.73,Print
5/14/2020,$5.27,$0.00,$4221.73,Print
5/14/2020,$5.12,$0.00,$4227.00,Print
5/14/2020,$3.52,$0.00,$4232.12,Print
5/14/2020,$5.12,$0.00,$4235.64,Print
5/14/2020,$3.25,$0.00,$4240.76,Print
5/14/2020,$3.25,$0.00,$4244.01,Print
5/14/2020,$5.12,$0.00,$4247.26,Print
5/14/2020,$4.00,$0.00,$4252.38,Print
5/14/2020,$2.78,$0.00,$4256.38,Print
5/14/2020,$5.54,$0.00,$4259.16,Print
5/14/2020,$5.12,$0.00,$4264.70,Print
5/14/2020,$3.31,$0.00,$4269.82,Print
5/14/2020,$2.84,$0.00,$4273.13,Print
5/14/2020,$2.74,$0.00,$4275.97,Print
5/14/2020,$3.25,$0.00,$4278.71,Print
5/14/2020,$3.05,$0.00,$4281.96,Print
5/14/2020,$2.84,$0.00,$4285.01,Print
5/14/2020,$2.78,$0.00,$4287.85,Print
5/14/2020,$2.74,$0.00,$4290.63,Print
5/14/2020,$2.74,$0.00,$4293.37,Print
5/14/2020,$2.78,$0.00,$4296.11,Print
5/14/2020,$2.74,$0.00,$4298.89,Print
5/14/2020,$3.23,$0.00,$4301.63,Print
5/14/2020,$3.25,$0.00,$4304.86,Print
5/14/2020,$2.78,$0.00,$4308.11,Print
5/14/2020,$2.74,$0.00,$4310.89,Print
5/14/2020,$2.74,$0.00,$4313.63,Print
5/14/2020,$2.78,$0.00,$4316.37,Print
5/14/2020,$3.23,$0.00,$4319.15,Print
5/14/2020,$2.84,$0.00,$4322.38,Print
5/14/2020,$2.78,$0.00,$4325.22,Print
5/14/2020,$2.76,$0.00,$4328.00,Print
5/14/2020,$2.74,$0.00,$4330.76,Print
5/14/2020,$2.78,$0.00,$4333.50,Print
5/14/2020,$3.25,$0.00,$4336.28,Print
5/14/2020,$3.21,$0.00,$4339.53,Print
5/14/2020,$2.84,$0.00,$4342.74,Print
5/14/2020,$2.84,$0.00,$4345.58,Print
5/14/2020,$2.74,$0.00,$4348.42,Print
5/14/2020,$2.84,$0.00,$4351.16,Print
5/14/2020,$2.74,$0.00,$4354.00,Print
5/14/2020,$4.00,$0.00,$4356.74,Print
5/14/2020,$2.78,$0.00,$4360.74,Print
5/14/2020,$2.78,$0.00,$4363.52,Print
5/14/2020,$3.52,$0.00,$4366.30,Print
5/14/2020,$2.78,$0.00,$4369.82,Print
5/14/2020,$2.84,$0.00,$4372.60,Print
5/14/2020,$2.78,$0.00,$4375.44,Print
5/14/2020,$3.67,$0.00,$4378.22,Print
5/14/2020,$2.78,$0.00,$4381.89,Print
5/14/2020,$2.78,$0.00,$4384.67,Print
5/14/2020,$2.74,$0.00,$4387.45,Print
5/14/2020,$2.76,$0.00,$4390.19,Print
5/14/2020,$2.74,$0.00,$4392.95,Print
5/14/2020,$2.76,$0.00,$4395.69,Print
5/14/2020,$2.74,$0.00,$4398.45,Print
5/14/2020,$3.39,$0.00,$4401.19,Print
5/14/2020,$2.74,$0.00,$4404.58,Print
5/14/2020,$2.78,$0.00,$4407.32,Print
5/14/2020,$2.78,$0.00,$4410.10,Print
5/14/2020,$2.78,$0.00,$4412.88,Print
5/14/2020,$2.74,$0.00,$4415.66,Print
5/14/2020,$3.25,$0.00,$4418.40,Print
5/14/2020,$3.21,$0.00,$4421.65,Print
5/14/2020,$2.78,$0.00,$4424.86,Print
5/14/2020,$3.25,$0.00,$4427.64,Print
5/14/2020,$3.21,$0.00,$4430.89,Print
5/14/2020,$3.39,$0.00,$4434.10,Print
5/14/2020,$3.25,$0.00,$4437.49,Print
5/14/2020,$2.78,$0.00,$4440.74,Print
5/14/2020,$2.74,$0.00,$4443.52,Print
5/14/2020,$2.84,$0.00,$4446.26,Print
5/14/2020,$2.78,$0.00,$4449.10,Print
5/14/2020,$2.74,$0.00,$4451.88,Print
5/14/2020,$2.84,$0.00,$4454.62,Print
5/14/2020,$2.74,$0.00,$4457.46,Print
5/14/2020,$2.78,$0.00,$4460.20,Print
5/14/2020,$2.78,$0.00,$4462.98,Print
5/14/2020,$3.25,$0.00,$4465.76,Print
5/14/2020,$3.25,$0.00,$4469.01,Print
5/14/2020,$2.76,$0.00,$4472.26,Print
5/14/2020,$2.74,$0.00,$4475.02,Print
5/14/2020,$2.78,$0.00,$4477.76,Print
5/14/2020,$3.25,$0.00,$4480.54,Print
5/14/2020,$2.78,$0.00,$4483.79,Print
5/14/2020,$3.25,$0.00,$4486.57,Print
5/14/2020,$3.25,$0.00,$4489.82,Print
5/14/2020,$2.78,$0.00,$4493.07,Print
5/14/2020,$2.78,$0.00,$4495.85,Print
5/14/2020,$2000.00,$0.00,$4498.63,Purchase
5/14/2020,$2.78,$0.00,$2498.63,Print
5/14/2020,$2.74,$0.00,$2501.41,Print
5/14/2020,$2.74,$0.00,$2504.15,Print
5/14/2020,$2.78,$0.00,$2506.89,Print
5/14/2020,$2.74,$0.00,$2509.67,Print
5/14/2020,$3.05,$0.00,$2512.41,Print
5/14/2020,$2.78,$0.00,$2515.46,Print
5/14/2020,$2.78,$0.00,$2518.24,Print
5/14/2020,$2.78,$0.00,$2521.02,Print
5/14/2020,$2.78,$0.00,$2523.80,Print
5/14/2020,$2.78,$0.00,$2526.58,Print
5/14/2020,$2.78,$0.00,$2529.36,Print
5/14/2020,$2.74,$0.00,$2532.14,Print
5/14/2020,$2.74,$0.00,$2534.88,Print
5/14/2020,$2.78,$0.00,$2537.62,Print
5/14/2020,$3.97,$0.00,$2540.40,Print
5/14/2020,$2.74,$0.00,$2544.37,Print
5/14/2020,$2.74,$0.00,$2547.11,Print
5/14/2020,$2.74,$0.00,$2549.85,Print
5/14/2020,$3.21,$0.00,$2552.59,Print
5/14/2020,$3.52,$0.00,$2555.80,Print
5/14/2020,$2.93,$0.00,$2559.32,Print
5/14/2020,$2.78,$0.00,$2562.25,Print
5/14/2020,$2.78,$0.00,$2565.03,Print
5/14/2020,$8.12,$0.00,$2567.81,Print
5/14/2020,$2.78,$0.00,$2575.93,Print
5/14/2020,$2.74,$0.00,$2578.71,Print
5/14/2020,$4.00,$0.00,$2581.45,Print
5/14/2020,$2.74,$0.00,$2585.45,Print
5/14/2020,$2.84,$0.00,$2588.19,Print
5/14/2020,$2.76,$0.00,$2591.03,Print
5/14/2020,$2.78,$0.00,$2593.79,Print
5/14/2020,$2.74,$0.00,$2596.57,Print
5/14/2020,$3.31,$0.00,$2599.31,Print
5/14/2020,$3.31,$0.00,$2602.62,Print
5/14/2020,$2.78,$0.00,$2605.93,Print
5/14/2020,$3.25,$0.00,$2608.71,Print
5/14/2020,$2.78,$0.00,$2611.96,Print
5/14/2020,$2.84,$0.00,$2614.74,Print
5/14/2020,$2.74,$0.00,$2617.58,Print
5/14/2020,$3.31,$0.00,$2620.32,Print
5/14/2020,$2.84,$0.00,$2623.63,Print
5/14/2020,$3.39,$0.00,$2626.47,Print
5/14/2020,$2.76,$0.00,$2629.86,Print
5/14/2020,$2.84,$0.00,$2632.62,Print
5/14/2020,$3.31,$0.00,$2635.46,Print
5/14/2020,$2.74,$0.00,$2638.77,Print
5/14/2020,$3.21,$0.00,$2641.51,Print
5/14/2020,$3.21,$0.00,$2644.72,Print
5/14/2020,$3.25,$0.00,$2647.93,Print
5/14/2020,$3.21,$0.00,$2651.18,Print
5/14/2020,$3.52,$0.00,$2654.39,Print
5/14/2020,$3.21,$0.00,$2657.91,Print
5/14/2020,$2.74,$0.00,$2661.12,Print
5/14/2020,$2.78,$0.00,$2663.86,Print
5/14/2020,$3.31,$0.00,$2666.64,Print
5/14/2020,$2.84,$0.00,$2669.95,Print
5/14/2020,$2.78,$0.00,$2672.79,Print
5/14/2020,$3.21,$0.00,$2675.57,Print
5/14/2020,$2.76,$0.00,$2678.78,Print
5/14/2020,$2.78,$0.00,$2681.54,Print
5/14/2020,$2.78,$0.00,$2684.32,Print
5/14/2020,$2.74,$0.00,$2687.10,Print
5/14/2020,$3.25,$0.00,$2689.84,Print
5/14/2020,$2.76,$0.00,$2693.09,Print
5/14/2020,$2.74,$0.00,$2695.85,Print
5/14/2020,$2.78,$0.00,$2698.59,Print
5/14/2020,$2.76,$0.00,$2701.37,Print
5/14/2020,$2.78,$0.00,$2704.13,Print
5/14/2020,$2.76,$0.00,$2706.91,Print
5/14/2020,$2.78,$0.00,$2709.67,Print
5/14/2020,$2.78,$0.00,$2712.45,Print
5/14/2020,$2.74,$0.00,$2715.23,Print
5/14/2020,$2.74,$0.00,$2717.97,Print
5/14/2020,$3.05,$0.00,$2720.71,Print
5/14/2020,$2.78,$0.00,$2723.76,Print
5/14/2020,$2.84,$0.00,$2726.54,Print
5/14/2020,$2.84,$0.00,$2729.38,Print
5/14/2020,$2.78,$0.00,$2732.22,Print
5/14/2020,$2.76,$0.00,$2735.00,Print
5/14/2020,$2.78,$0.00,$2737.76,Print
5/14/2020,$2.78,$0.00,$2740.54,Print
5/14/2020,$2.78,$0.00,$2743.32,Print
5/14/2020,$2.78,$0.00,$2746.10,Print
5/14/2020,$3.93,$0.00,$2748.88,Print
5/14/2020,$2.74,$0.00,$2752.81,Print
5/14/2020,$2.78,$0.00,$2755.55,Print
5/14/2020,$2.74,$0.00,$2758.33,Print
5/14/2020,$3.31,$0.00,$2761.07,Print
5/14/2020,$2.78,$0.00,$2764.38,Print
5/14/2020,$2.78,$0.00,$2767.16,Print
5/14/2020,$2.84,$0.00,$2769.94,Print
5/14/2020,$2.84,$0.00,$2772.78,Print
5/14/2020,$3.31,$0.00,$2775.62,Print
5/14/2020,$2.78,$0.00,$2778.93,Print
5/14/2020,$2.78,$0.00,$2781.71,Print
5/14/2020,$2.78,$0.00,$2784.49,Print
5/14/2020,$3.52,$0.00,$2787.27,Print
5/14/2020,$3.31,$0.00,$2790.79,Print
5/14/2020,$3.93,$0.00,$2794.10,Print
5/14/2020,$3.93,$0.00,$2798.03,Print
5/14/2020,$3.39,$0.00,$2801.96,Print
5/14/2020,$3.25,$0.00,$2805.35,Print
5/14/2020,$2.74,$0.00,$2808.60,Print
5/14/2020,$3.31,$0.00,$2811.34,Print
5/14/2020,$3.39,$0.00,$2814.65,Print
5/14/2020,$3.23,$0.00,$2818.04,Print
5/14/2020,$3.21,$0.00,$2821.27,Print
5/14/2020,$3.25,$0.00,$2824.48,Print
5/14/2020,$3.25,$0.00,$2827.73,Print
5/14/2020,$2.78,$0.00,$2830.98,Print
5/14/2020,$2.78,$0.00,$2833.76,Print
5/14/2020,$2.78,$0.00,$2836.54,Print
5/14/2020,$2.84,$0.00,$2839.32,Print
5/14/2020,$2.74,$0.00,$2842.16,Print
5/14/2020,$2.84,$0.00,$2844.90,Print
5/14/2020,$2.78,$0.00,$2847.74,Print
5/14/2020,$3.05,$0.00,$2850.52,Print
5/14/2020,$3.21,$0.00,$2853.57,Print
5/14/2020,$3.31,$0.00,$2856.78,Print
5/14/2020,$2.78,$0.00,$2860.09,Print
5/14/2020,$3.25,$0.00,$2862.87,Print
5/14/2020,$4.08,$0.00,$2866.12,Print
5/14/2020,$4.08,$0.00,$2870.20,Print
5/14/2020,$4.00,$0.00,$2874.28,Print
5/14/2020,$2.78,$0.00,$2878.28,Print
5/14/2020,$2.78,$0.00,$2881.06,Print
5/14/2020,$2.78,$0.00,$2883.84,Print
5/14/2020,$3.23,$0.00,$2886.62,Print
5/14/2020,$2.74,$0.00,$2889.85,Print
5/14/2020,$3.25,$0.00,$2892.59,Print
5/14/2020,$2.78,$0.00,$2895.84,Print
5/14/2020,$3.52,$0.00,$2898.62,Print
5/14/2020,$2.78,$0.00,$2902.14,Print
5/14/2020,$2.78,$0.00,$2904.92,Print
5/14/2020,$2.84,$0.00,$2907.70,Print
5/14/2020,$2.78,$0.00,$2910.54,Print
5/14/2020,$2.84,$0.00,$2913.32,Print
5/14/2020,$3.25,$0.00,$2916.16,Print
5/14/2020,$5.27,$0.00,$2919.41,Print
5/14/2020,$2.84,$0.00,$2924.68,Print
5/14/2020,$4.32,$0.00,$2927.52,Print
5/14/2020,$2.78,$0.00,$2931.84,Print
5/14/2020,$4.00,$0.00,$2934.62,Print
5/14/2020,$3.25,$0.00,$2938.62,Print
5/14/2020,$3.52,$0.00,$2941.87,Print
5/14/2020,$3.23,$0.00,$2945.39,Print
5/14/2020,$3.31,$0.00,$2948.62,Print
5/14/2020,$3.25,$0.00,$2951.93,Print
5/14/2020,$3.39,$0.00,$2955.18,Print
5/14/2020,$3.18,$0.00,$2958.57,Print
5/14/2020,$3.25,$0.00,$2961.75,Print
5/14/2020,$2.78,$0.00,$2965.00,Print
5/14/2020,$2.78,$0.00,$2967.78,Print
5/14/2020,$2.78,$0.00,$2970.56,Print
5/14/2020,$2.76,$0.00,$2973.34,Print
5/14/2020,$3.31,$0.00,$2976.10,Print
5/14/2020,$3.31,$0.00,$2979.41,Print
5/14/2020,$2.84,$0.00,$2982.72,Print
5/14/2020,$2.76,$0.00,$2985.56,Print
5/14/2020,$3.25,$0.00,$2988.32,Print
5/14/2020,$2.93,$0.00,$2991.57,Print
5/14/2020,$3.31,$0.00,$2994.50,Print
5/14/2020,$2.74,$0.00,$2997.81,Print
5/14/2020,$3.05,$0.00,$3000.55,Print
5/14/2020,$3.05,$0.00,$3003.60,Print
5/14/2020,$2.84,$0.00,$3006.65,Print
5/14/2020,$2.78,$0.00,$3009.49,Print
5/14/2020,$2.74,$0.00,$3012.27,Print
5/14/2020,$2.78,$0.00,$3015.01,Print
5/14/2020,$2.78,$0.00,$3017.79,Print
5/14/2020,$2.84,$0.00,$3020.57,Print
5/14/2020,$2.78,$0.00,$3023.41,Print
5/14/2020,$2.74,$0.00,$3026.19,Print
5/14/2020,$2.78,$0.00,$3028.93,Print
5/14/2020,$2.78,$0.00,$3031.71,Print
5/14/2020,$3.05,$0.00,$3034.49,Print
5/14/2020,$2.78,$0.00,$3037.54,Print
5/14/2020,$2.84,$0.00,$3040.32,Print
5/14/2020,$2.78,$0.00,$3043.16,Print
5/14/2020,$3.52,$0.00,$3045.94,Print
5/14/2020,$5.12,$0.00,$3049.46,Print
5/14/2020,$3.31,$0.00,$3054.58,Print
5/14/2020,$2.84,$0.00,$3057.89,Print
5/14/2020,$2.84,$0.00,$3060.73,Print
5/14/2020,$3.25,$0.00,$3063.57,Print
5/14/2020,$2.76,$0.00,$3066.82,Print
5/14/2020,$2.74,$0.00,$3069.58,Print
5/14/2020,$2.93,$0.00,$3072.32,Print
5/14/2020,$2.84,$0.00,$3075.25,Print
5/14/2020,$3.39,$0.00,$3078.09,Print
5/14/2020,$2.76,$0.00,$3081.48,Print
5/14/2020,$2.78,$0.00,$3084.24,Print
5/14/2020,$2.74,$0.00,$3087.02,Print
5/14/2020,$2.78,$0.00,$3089.76,Print
5/14/2020,$2.76,$0.00,$3092.54,Print
5/14/2020,$3.25,$0.00,$3095.30,Print
5/14/2020,$3.31,$0.00,$3098.55,Print
5/14/2020,$2.76,$0.00,$3101.86,Print
5/14/2020,$3.23,$0.00,$3104.62,Print
5/14/2020,$3.25,$0.00,$3107.85,Print
5/14/2020,$4.00,$0.00,$3111.10,Print
5/14/2020,$4.00,$0.00,$3115.10,Print
5/14/2020,$4.00,$0.00,$3119.10,Print
5/14/2020,$3.93,$0.00,$3123.10,Print
5/14/2020,$3.25,$0.00,$3127.03,Print
5/14/2020,$4.00,$0.00,$3130.28,Print
5/14/2020,$5.12,$0.00,$3134.28,Print
5/14/2020,$4.08,$0.00,$3139.40,Print
5/14/2020,$4.00,$0.00,$3143.48,Print
5/14/2020,$4.00,$0.00,$3147.48,Print
5/14/2020,$2.78,$0.00,$3151.48,Print
5/14/2020,$2.76,$0.00,$3154.26,Print
5/14/2020,$3.97,$0.00,$3157.02,Print
5/14/2020,$2.78,$0.00,$3160.99,Print
5/14/2020,$2.84,$0.00,$3163.77,Print
5/14/2020,$2.84,$0.00,$3166.61,Print
5/14/2020,$2.76,$0.00,$3169.45,Print
5/14/2020,$2.74,$0.00,$3172.21,Print
5/14/2020,$2.78,$0.00,$3174.95,Print
5/14/2020,$2.78,$0.00,$3177.73,Print
5/14/2020,$2.78,$0.00,$3180.51,Print
5/14/2020,$2.78,$0.00,$3183.29,Print
5/14/2020,$2.84,$0.00,$3186.07,Print
5/14/2020,$2.84,$0.00,$3188.91,Print
5/14/2020,$2.84,$0.00,$3191.75,Print
5/14/2020,$2.84,$0.00,$3194.59,Print
5/14/2020,$2.84,$0.00,$3197.43,Print
5/14/2020,$2.84,$0.00,$3200.27,Print
5/14/2020,$2.76,$0.00,$3203.11,Print
5/14/2020,$2.78,$0.00,$3205.87,Print
5/14/2020,$2.76,$0.00,$3208.65,Print
5/14/2020,$2.84,$0.00,$3211.41,Print
5/14/2020,$2.78,$0.00,$3214.25,Print
5/14/2020,$2.84,$0.00,$3217.03,Print
5/14/2020,$2.74,$0.00,$3219.87,Print
5/14/2020,$2.93,$0.00,$3222.61,Print
5/14/2020,$2.84,$0.00,$3225.54,Print
5/14/2020,$3.25,$0.00,$3228.38,Print
5/14/2020,$2.74,$0.00,$3231.63,Print
5/14/2020,$2.78,$0.00,$3234.37,Print
5/14/2020,$2.78,$0.00,$3237.15,Print
5/14/2020,$2.76,$0.00,$3239.93,Print
5/14/2020,$2.84,$0.00,$3242.69,Print
5/14/2020,$2.84,$0.00,$3245.53,Print
5/14/2020,$2.74,$0.00,$3248.37,Print
5/14/2020,$2.74,$0.00,$3251.11,Print
5/14/2020,$2.93,$0.00,$3253.85,Print
5/14/2020,$2.84,$0.00,$3256.78,Print
5/14/2020,$2.84,$0.00,$3259.62,Print
5/14/2020,$2.76,$0.00,$3262.46,Print
5/14/2020,$2.84,$0.00,$3265.22,Print
5/14/2020,$2.76,$0.00,$3268.06,Print
5/14/2020,$3.31,$0.00,$3270.82,Print
5/14/2020,$3.39,$0.00,$3274.13,Print
5/14/2020,$2.78,$0.00,$3277.52,Print
5/14/2020,$3.23,$0.00,$3280.30,Print
5/14/2020,$2.84,$0.00,$3283.53,Print
5/14/2020,$2.93,$0.00,$3286.37,Print
5/14/2020,$5.12,$0.00,$3289.30,Print
5/14/2020,$5.27,$0.00,$3294.42,Print
5/14/2020,$2.84,$0.00,$3299.69,Print
5/14/2020,$5.12,$0.00,$3302.53,Print
5/14/2020,$3.31,$0.00,$3307.65,Print
5/14/2020,$2.84,$0.00,$3310.96,Print
5/14/2020,$5.27,$0.00,$3313.80,Print
5/14/2020,$2.78,$0.00,$3319.07,Print
5/14/2020,$2.93,$0.00,$3321.85,Print
5/14/2020,$5.40,$0.00,$3324.78,Print
5/14/2020,$2.76,$0.00,$3330.18,Print
5/14/2020,$4.00,$0.00,$3332.94,Print
5/14/2020,$2.84,$0.00,$3336.94,Print
5/14/2020,$2.78,$0.00,$3339.78,Print
5/14/2020,$2.84,$0.00,$3342.56,Print
5/14/2020,$2.76,$0.00,$3345.40,Print
5/14/2020,$2.84,$0.00,$3348.16,Print
5/14/2020,$2.76,$0.00,$3351.00,Print
5/14/2020,$2.78,$0.00,$3353.76,Print
5/14/2020,$3.93,$0.00,$3356.54,Print
5/14/2020,$3.25,$0.00,$3360.47,Print
5/14/2020,$2.78,$0.00,$3363.72,Print
5/14/2020,$2.76,$0.00,$3366.50,Print
5/14/2020,$2.78,$0.00,$3369.26,Print
5/14/2020,$2.78,$0.00,$3372.04,Print
5/14/2020,$2.93,$0.00,$3374.82,Print
5/14/2020,$2.78,$0.00,$3377.75,Print
5/14/2020,$2.84,$0.00,$3380.53,Print
5/14/2020,$2.78,$0.00,$3383.37,Print
5/14/2020,$2.84,$0.00,$3386.15,Print
5/14/2020,$2.84,$0.00,$3388.99,Print
5/14/2020,$2.78,$0.00,$3391.83,Print
5/14/2020,$2.74,$0.00,$3394.61,Print
5/14/2020,$2.76,$0.00,$3397.35,Print
5/14/2020,$2.76,$0.00,$3400.11,Print
5/14/2020,$2.78,$0.00,$3402.87,Print
5/14/2020,$2.84,$0.00,$3405.65,Print
5/14/2020,$3.23,$0.00,$3408.49,Print
5/14/2020,$2.78,$0.00,$3411.72,Print
5/14/2020,$2.76,$0.00,$3414.50,Print
5/14/2020,$2.78,$0.00,$3417.26,Print
5/14/2020,$2.78,$0.00,$3420.04,Print
5/14/2020,$2.84,$0.00,$3422.82,Print
5/14/2020,$2.78,$0.00,$3425.66,Print
5/14/2020,$2.76,$0.00,$3428.44,Print
5/14/2020,$4.00,$0.00,$3431.20,Print
5/14/2020,$5.04,$0.00,$3435.20,Print
5/14/2020,$5.12,$0.00,$3440.24,Print
5/14/2020,$3.23,$0.00,$3445.36,Print
5/14/2020,$2.74,$0.00,$3448.59,Print
5/14/2020,$3.21,$0.00,$3451.33,Print
5/14/2020,$3.39,$0.00,$3454.54,Print
5/14/2020,$2.76,$0.00,$3457.93,Print
5/14/2020,$3.31,$0.00,$3460.69,Print
5/14/2020,$2.84,$0.00,$3464.00,Print
5/14/2020,$2.78,$0.00,$3466.84,Print
5/14/2020,$3.93,$0.00,$3469.62,Print
5/14/2020,$2.84,$0.00,$3473.55,Print
5/14/2020,$3.25,$0.00,$3476.39,Print
5/14/2020,$3.25,$0.00,$3479.64,Print
5/14/2020,$3.21,$0.00,$3482.89,Print
5/14/2020,$3.25,$0.00,$3486.10,Print
5/14/2020,$2.78,$0.00,$3489.35,Print
5/14/2020,$7.84,$0.00,$3492.13,Print
5/14/2020,$5.12,$0.00,$3499.97,Print
5/14/2020,$2.78,$0.00,$3505.09,Print
5/14/2020,$5.04,$0.00,$3507.87,Print
5/14/2020,$3.25,$0.00,$3512.91,Print
5/14/2020,$5.04,$0.00,$3516.16,Print
5/14/2020,$2.78,$0.00,$3521.20,Print
5/14/2020,$3.67,$0.00,$3523.98,Print
5/14/2020,$2.76,$0.00,$3527.65,Print
5/14/2020,$2.74,$0.00,$3530.41,Print
5/14/2020,$3.18,$0.00,$3533.15,Print
5/14/2020,$3.25,$0.00,$3536.33,Print
5/14/2020,$2.78,$0.00,$3539.58,Print
5/14/2020,$3.21,$0.00,$3542.36,Print
5/14/2020,$3.21,$0.00,$3545.57,Print
5/14/2020,$3.21,$0.00,$3548.78,Print
5/14/2020,$3.39,$0.00,$3551.99,Print
5/14/2020,$3.23,$0.00,$3555.38,Print
5/14/2020,$3.21,$0.00,$3558.61,Print
5/14/2020,$3.31,$0.00,$3561.82,Print
5/14/2020,$2.78,$0.00,$3565.13,Print
5/14/2020,$3.21,$0.00,$3567.91,Print
5/14/2020,$3.21,$0.00,$3571.12,Print
5/14/2020,$3.21,$0.00,$3574.33,Print
5/14/2020,$3.25,$0.00,$3577.54,Print
5/14/2020,$2.74,$0.00,$3580.79,Print
5/14/2020,$3.25,$0.00,$3583.53,Print
5/14/2020,$5.08,$0.00,$3586.78,Print
5/14/2020,$3.25,$0.00,$3591.86,Print
5/14/2020,$3.52,$0.00,$3595.11,Print
5/14/2020,$3.23,$0.00,$3598.63,Print
5/14/2020,$2.76,$0.00,$3601.86,Print
5/14/2020,$2.84,$0.00,$3604.62,Print
5/14/2020,$2.76,$0.00,$3607.46,Print
5/14/2020,$2.78,$0.00,$3610.22,Print
5/14/2020,$2.78,$0.00,$3613.00,Print
5/14/2020,$3.25,$0.00,$3615.78,Print
5/14/2020,$2.74,$0.00,$3619.03,Print
5/14/2020,$3.25,$0.00,$3621.77,Print
5/14/2020,$2.74,$0.00,$3625.02,Print
5/13/2020,$3.25,$0.00,$3627.76,Print
5/13/2020,$3.21,$0.00,$3631.01,Print
5/13/2020,$2.84,$0.00,$3634.22,Print
5/13/2020,$3.21,$0.00,$3637.06,Print
5/13/2020,$3.21,$0.00,$3640.27,Print
5/13/2020,$3.25,$0.00,$3643.48,Print
5/13/2020,$3.25,$0.00,$3646.73,Print
5/13/2020,$2.84,$0.00,$3649.98,Print
5/13/2020,$3.23,$0.00,$3652.82,Print
5/13/2020,$2.84,$0.00,$3656.05,Print
5/13/2020,$2.76,$0.00,$3658.89,Print
5/13/2020,$2.76,$0.00,$3661.65,Print
5/13/2020,$2.84,$0.00,$3664.41,Print
5/13/2020,$3.25,$0.00,$3667.25,Print
5/13/2020,$3.25,$0.00,$3670.50,Print
5/13/2020,$3.97,$0.00,$3673.75,Print
5/13/2020,$2.76,$0.00,$3677.72,Print
5/13/2020,$4.08,$0.00,$3680.48,Print
5/13/2020,$2.84,$0.00,$3684.56,Print
5/13/2020,$2.76,$0.00,$3687.40,Print
5/13/2020,$2.78,$0.00,$3690.16,Print
5/13/2020,$5.27,$0.00,$3692.94,Print
5/13/2020,$2.78,$0.00,$3698.21,Print
5/13/2020,$2.78,$0.00,$3700.99,Print
5/13/2020,$2.78,$0.00,$3703.77,Print
5/13/2020,$2.78,$0.00,$3706.55,Print
5/13/2020,$2.78,$0.00,$3709.33,Print
5/13/2020,$5.27,$0.00,$3712.11,Print
5/13/2020,$3.93,$0.00,$3717.38,Print
5/13/2020,$4.00,$0.00,$3721.31,Print
5/13/2020,$4.08,$0.00,$3725.31,Print
5/13/2020,$4.00,$0.00,$3729.39,Print
5/13/2020,$4.00,$0.00,$3733.39,Print
5/13/2020,$2.74,$0.00,$3737.39,Print
5/13/2020,$3.25,$0.00,$3740.13,Print
5/13/2020,$3.21,$0.00,$3743.38,Print
5/13/2020,$2.78,$0.00,$3746.59,Print
5/13/2020,$2.78,$0.00,$3749.37,Print
5/13/2020,$2.74,$0.00,$3752.15,Print
5/13/2020,$2.74,$0.00,$3754.89,Print
5/13/2020,$2.76,$0.00,$3757.63,Print
5/13/2020,$2.78,$0.00,$3760.39,Print
5/13/2020,$2.78,$0.00,$3763.17,Print
5/13/2020,$2.78,$0.00,$3765.95,Print
5/13/2020,$3.21,$0.00,$3768.73,Print
5/13/2020,$3.25,$0.00,$3771.94,Print
5/13/2020,$2.74,$0.00,$3775.19,Print
5/13/2020,$2.76,$0.00,$3777.93,Print
5/13/2020,$2.78,$0.00,$3780.69,Print
5/13/2020,$2.78,$0.00,$3783.47,Print
5/13/2020,$3.21,$0.00,$3786.25,Print
5/13/2020,$2.78,$0.00,$3789.46,Print
5/13/2020,$2.84,$0.00,$3792.24,Print
5/13/2020,$2.78,$0.00,$3795.08,Print
5/13/2020,$2.74,$0.00,$3797.86,Print
5/13/2020,$2.74,$0.00,$3800.60,Print
5/13/2020,$2.74,$0.00,$3803.34,Print
5/13/2020,$3.25,$0.00,$3806.08,Print
5/13/2020,$2.78,$0.00,$3809.33,Print
5/13/2020,$2.74,$0.00,$3812.11,Print
5/13/2020,$3.25,$0.00,$3814.85,Print
5/13/2020,$3.25,$0.00,$3818.10,Print
5/13/2020,$2.74,$0.00,$3821.35,Print
5/13/2020,$2.84,$0.00,$3824.09,Print
5/13/2020,$3.21,$0.00,$3826.93,Print
5/13/2020,$2.74,$0.00,$3830.14,Print
5/13/2020,$2.74,$0.00,$3832.88,Print
5/13/2020,$2.78,$0.00,$3835.62,Print
5/13/2020,$3.21,$0.00,$3838.40,Print
5/13/2020,$3.23,$0.00,$3841.61,Print
5/13/2020,$2.93,$0.00,$3844.84,Print
5/13/2020,$3.31,$0.00,$3847.77,Print
5/13/2020,$3.31,$0.00,$3851.08,Print
5/13/2020,$4.08,$0.00,$3854.39,Print
5/13/2020,$3.39,$0.00,$3858.47,Print
5/13/2020,$3.93,$0.00,$3861.86,Print
5/13/2020,$5.04,$0.00,$3865.79,Print
5/13/2020,$7.56,$0.00,$3870.83,Print
5/13/2020,$5.08,$0.00,$3878.39,Print
5/13/2020,$3.25,$0.00,$3883.47,Print
5/13/2020,$7.64,$0.00,$3886.72,Print
5/13/2020,$3.21,$0.00,$3894.36,Print
5/13/2020,$3.25,$0.00,$3897.57,Print
5/13/2020,$3.31,$0.00,$3900.82,Print
5/13/2020,$2.84,$0.00,$3904.13,Print
5/13/2020,$3.18,$0.00,$3906.97,Print
5/13/2020,$3.52,$0.00,$3910.15,Print
5/13/2020,$2.84,$0.00,$3913.67,Print
5/13/2020,$2.78,$0.00,$3916.51,Print
5/13/2020,$2.78,$0.00,$3919.29,Print
5/13/2020,$2.74,$0.00,$3922.07,Print
5/13/2020,$2.84,$0.00,$3924.81,Print
5/13/2020,$3.21,$0.00,$3927.65,Print
5/13/2020,$2.78,$0.00,$3930.86,Print
5/13/2020,$2.76,$0.00,$3933.64,Print
5/13/2020,$2.78,$0.00,$3936.40,Print
5/13/2020,$2.78,$0.00,$3939.18,Print
5/13/2020,$2.78,$0.00,$3941.96,Print
5/13/2020,$2.78,$0.00,$3944.74,Print
5/13/2020,$2.74,$0.00,$3947.52,Print
5/13/2020,$2.84,$0.00,$3950.26,Print
5/13/2020,$2.78,$0.00,$3953.10,Print
5/13/2020,$3.25,$0.00,$3955.88,Print
5/13/2020,$2.78,$0.00,$3959.13,Print
5/13/2020,$2.78,$0.00,$3961.91,Print
5/13/2020,$2.74,$0.00,$3964.69,Print
5/13/2020,$2.78,$0.00,$3967.43,Print
5/13/2020,$2.76,$0.00,$3970.21,Print
5/13/2020,$2.78,$0.00,$3972.97,Print
5/13/2020,$3.52,$0.00,$3975.75,Print
5/13/2020,$2.76,$0.00,$3979.27,Print
5/13/2020,$2.74,$0.00,$3982.03,Print
5/13/2020,$3.21,$0.00,$3984.77,Print
5/13/2020,$2.76,$0.00,$3987.98,Print
5/13/2020,$2.84,$0.00,$3990.74,Print
5/13/2020,$2.74,$0.00,$3993.58,Print
5/13/2020,$3.21,$0.00,$3996.32,Print
5/13/2020,$2.78,$0.00,$3999.53,Print
5/13/2020,$2.76,$0.00,$4002.31,Print
5/13/2020,$2.78,$0.00,$4005.07,Print
5/13/2020,$2.78,$0.00,$4007.85,Print
5/13/2020,$2.74,$0.00,$4010.63,Print
5/13/2020,$2.76,$0.00,$4013.37,Print
5/13/2020,$2.74,$0.00,$4016.13,Print
5/13/2020,$2.76,$0.00,$4018.87,Print
5/13/2020,$2.78,$0.00,$4021.63,Print
5/13/2020,$2.76,$0.00,$4024.41,Print
5/13/2020,$2.78,$0.00,$4027.17,Print
5/13/2020,$2.78,$0.00,$4029.95,Print
5/13/2020,$2.78,$0.00,$4032.73,Print
5/13/2020,$2.78,$0.00,$4035.51,Print
5/13/2020,$2.78,$0.00,$4038.29,Print
5/13/2020,$2.76,$0.00,$4041.07,Print
5/13/2020,$2.78,$0.00,$4043.83,Print
5/13/2020,$2.74,$0.00,$4046.61,Print
5/13/2020,$2.76,$0.00,$4049.35,Print
5/13/2020,$2.78,$0.00,$4052.11,Print
5/13/2020,$2.84,$0.00,$4054.89,Print
5/13/2020,$2.74,$0.00,$4057.73,Print
5/13/2020,$2.84,$0.00,$4060.47,Print
5/13/2020,$3.23,$0.00,$4063.31,Print
5/13/2020,$3.25,$0.00,$4066.54,Print
5/13/2020,$2.84,$0.00,$4069.79,Print
5/13/2020,$2.74,$0.00,$4072.63,Print
5/13/2020,$2.76,$0.00,$4075.37,Print
5/13/2020,$3.31,$0.00,$4078.13,Print
5/13/2020,$2.78,$0.00,$4081.44,Print
5/13/2020,$5.40,$0.00,$4084.22,Print
5/13/2020,$7.80,$0.00,$4089.62,Print
5/13/2020,$5.27,$0.00,$4097.42,Print
5/13/2020,$2.78,$0.00,$4102.69,Print
5/13/2020,$5.12,$0.00,$4105.47,Print
5/13/2020,$3.23,$0.00,$4110.59,Print
5/13/2020,$2.84,$0.00,$4113.82,Print
5/13/2020,$2.78,$0.00,$4116.66,Print
5/13/2020,$3.05,$0.00,$4119.44,Print
5/13/2020,$2.84,$0.00,$4122.49,Print
5/13/2020,$2.78,$0.00,$4125.33,Print
5/13/2020,$2.78,$0.00,$4128.11,Print
5/13/2020,$3.25,$0.00,$4130.89,Print
5/13/2020,$2.78,$0.00,$4134.14,Print
5/13/2020,$2.76,$0.00,$4136.92,Print
5/13/2020,$3.31,$0.00,$4139.68,Print
5/13/2020,$2.78,$0.00,$4142.99,Print
5/13/2020,$2.76,$0.00,$4145.77,Print
5/13/2020,$2.84,$0.00,$4148.53,Print
5/13/2020,$2.74,$0.00,$4151.37,Print
5/13/2020,$2.78,$0.00,$4154.11,Print
5/13/2020,$2.76,$0.00,$4156.89,Print
5/13/2020,$2.76,$0.00,$4159.65,Print
5/13/2020,$5.12,$0.00,$4162.41,Print
5/13/2020,$5.04,$0.00,$4167.53,Print
5/13/2020,$2.74,$0.00,$4172.57,Print
5/13/2020,$2.93,$0.00,$4175.31,Print
5/13/2020,$2.74,$0.00,$4178.24,Print
5/13/2020,$2.78,$0.00,$4180.98,Print
5/13/2020,$7.64,$0.00,$4183.76,Print
5/13/2020,$3.31,$0.00,$4191.40,Print
5/13/2020,$5.12,$0.00,$4194.71,Print
5/13/2020,$2.84,$0.00,$4199.83,Print
5/13/2020,$3.23,$0.00,$4202.67,Print
5/13/2020,$3.31,$0.00,$4205.90,Print
5/13/2020,$2.78,$0.00,$4209.21,Print
5/13/2020,$5.04,$0.00,$4211.99,Print
5/13/2020,$2.84,$0.00,$4217.03,Print
5/13/2020,$3.93,$0.00,$4219.87,Print
5/13/2020,$2.78,$0.00,$4223.80,Print
5/13/2020,$3.31,$0.00,$4226.58,Print
5/13/2020,$2.78,$0.00,$4229.89,Print
5/13/2020,$3.31,$0.00,$4232.67,Print
5/13/2020,$3.31,$0.00,$4235.98,Print
5/13/2020,$2.84,$0.00,$4239.29,Print
5/13/2020,$2.93,$0.00,$4242.13,Print
5/13/2020,$2.78,$0.00,$4245.06,Print
5/13/2020,$2.74,$0.00,$4247.84,Print
5/13/2020,$3.05,$0.00,$4250.58,Print
5/13/2020,$3.25,$0.00,$4253.63,Print
5/13/2020,$3.52,$0.00,$4256.88,Print
5/13/2020,$2.78,$0.00,$4260.40,Print
5/13/2020,$3.93,$0.00,$4263.18,Print
5/13/2020,$2.84,$0.00,$4267.11,Print
5/13/2020,$2.84,$0.00,$4269.95,Print
5/13/2020,$3.31,$0.00,$4272.79,Print
5/13/2020,$8.12,$0.00,$4276.10,Print
5/13/2020,$2.78,$0.00,$4284.22,Print
5/13/2020,$2.78,$0.00,$4287.00,Print
5/13/2020,$2.74,$0.00,$4289.78,Print
5/13/2020,$2.76,$0.00,$4292.52,Print
5/13/2020,$2.78,$0.00,$4295.28,Print
5/13/2020,$2.76,$0.00,$4298.06,Print
5/13/2020,$2.78,$0.00,$4300.82,Print
5/13/2020,$2.84,$0.00,$4303.60,Print
5/13/2020,$4.08,$0.00,$4306.44,Print
5/13/2020,$2.84,$0.00,$4310.52,Print
5/13/2020,$3.39,$0.00,$4313.36,Print
5/13/2020,$3.52,$0.00,$4316.75,Print
5/13/2020,$3.31,$0.00,$4320.27,Print
5/13/2020,$2.74,$0.00,$4323.58,Print
5/13/2020,$2.78,$0.00,$4326.32,Print
5/13/2020,$3.05,$0.00,$4329.10,Print
5/13/2020,$2.74,$0.00,$4332.15,Print
5/13/2020,$2.93,$0.00,$4334.89,Print
5/13/2020,$3.31,$0.00,$4337.82,Print
5/13/2020,$3.31,$0.00,$4341.13,Print
5/13/2020,$3.25,$0.00,$4344.44,Print
5/13/2020,$3.25,$0.00,$4347.69,Print
5/13/2020,$2.74,$0.00,$4350.94,Print
5/13/2020,$5.70,$0.00,$4353.68,Print
5/13/2020,$2.84,$0.00,$4359.38,Print
5/13/2020,$2.74,$0.00,$4362.22,Print
5/13/2020,$2.78,$0.00,$4364.96,Print
5/13/2020,$2.84,$0.00,$4367.74,Print
5/13/2020,$2.78,$0.00,$4370.58,Print
5/13/2020,$2.84,$0.00,$4373.36,Print
5/13/2020,$2.78,$0.00,$4376.20,Print
5/13/2020,$2.78,$0.00,$4378.98,Print
5/13/2020,$8.23,$0.00,$4381.76,Print
5/13/2020,$3.21,$0.00,$4389.99,Print
5/13/2020,$2.78,$0.00,$4393.20,Print
5/13/2020,$4.00,$0.00,$4395.98,Print
5/13/2020,$4.08,$0.00,$4399.98,Print
5/13/2020,$4.08,$0.00,$4404.06,Print
5/13/2020,$2.74,$0.00,$4408.14,Print
5/13/2020,$2.78,$0.00,$4410.88,Print
5/13/2020,$2.84,$0.00,$4413.66,Print
5/13/2020,$3.25,$0.00,$4416.50,Print
5/13/2020,$2.74,$0.00,$4419.75,Print
5/13/2020,$3.05,$0.00,$4422.49,Print
5/13/2020,$4.18,$0.00,$4425.54,Print
5/13/2020,$4.08,$0.00,$4429.72,Print
5/13/2020,$4.46,$0.00,$4433.80,Print
5/13/2020,$3.25,$0.00,$4438.26,Print
5/13/2020,$3.25,$0.00,$4441.51,Print
5/13/2020,$3.31,$0.00,$4444.76,Print
5/13/2020,$3.67,$0.00,$4448.07,Print
5/13/2020,$3.31,$0.00,$4451.74,Print
5/13/2020,$3.25,$0.00,$4455.05,Print
5/13/2020,$5.12,$0.00,$4458.30,Print
5/13/2020,$2.84,$0.00,$4463.42,Print
5/13/2020,$3.25,$0.00,$4466.26,Print
5/13/2020,$3.52,$0.00,$4469.51,Print
5/13/2020,$3.97,$0.00,$4473.03,Print
5/13/2020,$2.84,$0.00,$4477.00,Print
5/13/2020,$4.32,$0.00,$4479.84,Print
5/13/2020,$2.76,$0.00,$4484.16,Print
5/13/2020,$2.78,$0.00,$4486.92,Print
5/13/2020,$2.74,$0.00,$4489.70,Print
5/13/2020,$2.84,$0.00,$4492.44,Print
5/13/2020,$2.84,$0.00,$4495.28,Print
5/13/2020,$2000.00,$0.00,$4498.12,Purchase
5/13/2020,$2.84,$0.00,$2498.12,Print
5/13/2020,$3.25,$0.00,$2500.96,Print
5/13/2020,$2.84,$0.00,$2504.21,Print
5/13/2020,$2.74,$0.00,$2507.05,Print
5/13/2020,$2.74,$0.00,$2509.79,Print
5/13/2020,$4.08,$0.00,$2512.53,Print
5/13/2020,$2.84,$0.00,$2516.61,Print
5/13/2020,$2.84,$0.00,$2519.45,Print
5/13/2020,$2.78,$0.00,$2522.29,Print
5/13/2020,$2.84,$0.00,$2525.07,Print
5/13/2020,$2.84,$0.00,$2527.91,Print
5/13/2020,$2.78,$0.00,$2530.75,Print
5/13/2020,$2.78,$0.00,$2533.53,Print
5/13/2020,$2.78,$0.00,$2536.31,Print
5/13/2020,$2.78,$0.00,$2539.09,Print
5/13/2020,$2.76,$0.00,$2541.87,Print
5/13/2020,$3.25,$0.00,$2544.63,Print
5/13/2020,$3.21,$0.00,$2547.88,Print
5/13/2020,$2.76,$0.00,$2551.09,Print
5/13/2020,$2.78,$0.00,$2553.85,Print
5/13/2020,$2.84,$0.00,$2556.63,Print
5/13/2020,$2.84,$0.00,$2559.47,Print
5/13/2020,$2.78,$0.00,$2562.31,Print
5/13/2020,$2.78,$0.00,$2565.09,Print
5/13/2020,$2.78,$0.00,$2567.87,Print
5/13/2020,$2.78,$0.00,$2570.65,Print
5/13/2020,$3.25,$0.00,$2573.43,Print
5/13/2020,$3.25,$0.00,$2576.68,Print
5/13/2020,$3.25,$0.00,$2579.93,Print
5/13/2020,$3.25,$0.00,$2583.18,Print
5/13/2020,$2.84,$0.00,$2586.43,Print
5/13/2020,$3.31,$0.00,$2589.27,Print
5/13/2020,$4.00,$0.00,$2592.58,Print
5/13/2020,$3.23,$0.00,$2596.58,Print
5/13/2020,$2.74,$0.00,$2599.81,Print
5/13/2020,$3.25,$0.00,$2602.55,Print
5/13/2020,$2.78,$0.00,$2605.80,Print
5/13/2020,$2.84,$0.00,$2608.58,Print
5/13/2020,$2.78,$0.00,$2611.42,Print
5/13/2020,$2.76,$0.00,$2614.20,Print
5/13/2020,$2.74,$0.00,$2616.96,Print
5/13/2020,$3.31,$0.00,$2619.70,Print
5/13/2020,$2.84,$0.00,$2623.01,Print
5/13/2020,$5.27,$0.00,$2625.85,Print
5/13/2020,$3.21,$0.00,$2631.12,Print
5/13/2020,$3.25,$0.00,$2634.33,Print
5/13/2020,$3.25,$0.00,$2637.58,Print
5/13/2020,$3.25,$0.00,$2640.83,Print
5/13/2020,$3.25,$0.00,$2644.08,Print
5/13/2020,$3.21,$0.00,$2647.33,Print
5/13/2020,$3.52,$0.00,$2650.54,Print
5/13/2020,$2.84,$0.00,$2654.06,Print
5/13/2020,$3.25,$0.00,$2656.90,Print
5/13/2020,$3.31,$0.00,$2660.15,Print
5/13/2020,$3.25,$0.00,$2663.46,Print
5/13/2020,$2.78,$0.00,$2666.71,Print
5/13/2020,$3.39,$0.00,$2669.49,Print
5/13/2020,$2.78,$0.00,$2672.88,Print
5/13/2020,$3.31,$0.00,$2675.66,Print
5/13/2020,$8.15,$0.00,$2678.97,Print
5/13/2020,$2.76,$0.00,$2687.12,Print
5/13/2020,$3.25,$0.00,$2689.88,Print
5/13/2020,$2.76,$0.00,$2693.13,Print
5/13/2020,$2.74,$0.00,$2695.89,Print
5/13/2020,$3.25,$0.00,$2698.63,Print
5/13/2020,$2.78,$0.00,$2701.88,Print
5/13/2020,$2.76,$0.00,$2704.66,Print
5/13/2020,$2.78,$0.00,$2707.42,Print
5/13/2020,$2.74,$0.00,$2710.20,Print
5/13/2020,$2.74,$0.00,$2712.94,Print
5/13/2020,$2.84,$0.00,$2715.68,Print
5/13/2020,$2.78,$0.00,$2718.52,Print
5/13/2020,$3.25,$0.00,$2721.30,Print
5/13/2020,$2.78,$0.00,$2724.55,Print
5/13/2020,$2.74,$0.00,$2727.33,Print
5/13/2020,$3.31,$0.00,$2730.07,Print
5/13/2020,$2.84,$0.00,$2733.38,Print
5/13/2020,$3.05,$0.00,$2736.22,Print
5/13/2020,$3.23,$0.00,$2739.27,Print
5/13/2020,$2.78,$0.00,$2742.50,Print
5/13/2020,$3.25,$0.00,$2745.28,Print
5/13/2020,$3.05,$0.00,$2748.53,Print
5/13/2020,$2.78,$0.00,$2751.58,Print
5/13/2020,$3.25,$0.00,$2754.36,Print
5/13/2020,$2.84,$0.00,$2757.61,Print
5/13/2020,$3.31,$0.00,$2760.45,Print
5/13/2020,$2.74,$0.00,$2763.76,Print
5/13/2020,$2.74,$0.00,$2766.50,Print
5/13/2020,$2.74,$0.00,$2769.24,Print
5/13/2020,$2.78,$0.00,$2771.98,Print
5/13/2020,$3.23,$0.00,$2774.76,Print
5/13/2020,$2.76,$0.00,$2777.99,Print
5/13/2020,$2.74,$0.00,$2780.75,Print
5/13/2020,$2.74,$0.00,$2783.49,Print
5/13/2020,$2.84,$0.00,$2786.23,Print
5/13/2020,$3.25,$0.00,$2789.07,Print
5/13/2020,$3.05,$0.00,$2792.32,Print
5/13/2020,$3.25,$0.00,$2795.37,Print
5/13/2020,$3.23,$0.00,$2798.62,Print
5/13/2020,$2.74,$0.00,$2801.85,Print
5/13/2020,$2.78,$0.00,$2804.59,Print
5/13/2020,$2.78,$0.00,$2807.37,Print
5/13/2020,$2.78,$0.00,$2810.15,Print
5/13/2020,$2.78,$0.00,$2812.93,Print
5/13/2020,$4.00,$0.00,$2815.71,Print
5/13/2020,$4.08,$0.00,$2819.71,Print
5/13/2020,$2.84,$0.00,$2823.79,Print
5/13/2020,$2.74,$0.00,$2826.63,Print
5/13/2020,$2.74,$0.00,$2829.37,Print
5/13/2020,$4.00,$0.00,$2832.11,Print
5/13/2020,$2.84,$0.00,$2836.11,Print
5/13/2020,$2.76,$0.00,$2838.95,Print
5/13/2020,$3.93,$0.00,$2841.71,Print
5/13/2020,$3.05,$0.00,$2845.64,Print
5/13/2020,$3.05,$0.00,$2848.69,Print
5/13/2020,$2.78,$0.00,$2851.74,Print
5/13/2020,$2.78,$0.00,$2854.52,Print
5/13/2020,$3.25,$0.00,$2857.30,Print
5/13/2020,$5.40,$0.00,$2860.55,Print
5/13/2020,$3.25,$0.00,$2865.95,Print
5/13/2020,$3.25,$0.00,$2869.20,Print
5/13/2020,$3.23,$0.00,$2872.45,Print
5/13/2020,$2.78,$0.00,$2875.68,Print
5/13/2020,$2.84,$0.00,$2878.46,Print
5/13/2020,$4.32,$0.00,$2881.30,Print
5/13/2020,$4.18,$0.00,$2885.62,Print
5/13/2020,$2.74,$0.00,$2889.80,Print
5/13/2020,$2.74,$0.00,$2892.54,Print
5/13/2020,$2.74,$0.00,$2895.28,Print
5/13/2020,$2.74,$0.00,$2898.02,Print
5/13/2020,$2.78,$0.00,$2900.76,Print
5/13/2020,$2.76,$0.00,$2903.54,Print
5/13/2020,$4.08,$0.00,$2906.30,Print
5/13/2020,$5.08,$0.00,$2910.38,Print
5/13/2020,$2.76,$0.00,$2915.46,Print
5/13/2020,$3.23,$0.00,$2918.22,Print
5/13/2020,$5.12,$0.00,$2921.45,Print
5/13/2020,$2.76,$0.00,$2926.57,Print
5/13/2020,$7.56,$0.00,$2929.33,Print
5/13/2020,$3.21,$0.00,$2936.89,Print
5/13/2020,$7.64,$0.00,$2940.10,Print
5/13/2020,$3.23,$0.00,$2947.74,Print
5/13/2020,$2.84,$0.00,$2950.97,Print
5/13/2020,$2.76,$0.00,$2953.81,Print
5/13/2020,$3.31,$0.00,$2956.57,Print
5/13/2020,$3.25,$0.00,$2959.88,Print
5/13/2020,$3.25,$0.00,$2963.13,Print
5/13/2020,$2.84,$0.00,$2966.38,Print
5/13/2020,$2.84,$0.00,$2969.22,Print
5/13/2020,$3.31,$0.00,$2972.06,Print
5/13/2020,$2.78,$0.00,$2975.37,Print
5/13/2020,$3.39,$0.00,$2978.15,Print
5/13/2020,$2.74,$0.00,$2981.54,Print
5/13/2020,$3.31,$0.00,$2984.28,Print
5/13/2020,$2.78,$0.00,$2987.59,Print
5/13/2020,$2.93,$0.00,$2990.37,Print
5/13/2020,$3.23,$0.00,$2993.30,Print
5/13/2020,$3.21,$0.00,$2996.53,Print
5/13/2020,$2.93,$0.00,$2999.74,Print
5/13/2020,$2.74,$0.00,$3002.67,Print
5/13/2020,$5.40,$0.00,$3005.41,Print
5/13/2020,$2.78,$0.00,$3010.81,Print
5/13/2020,$3.21,$0.00,$3013.59,Print
5/13/2020,$2.74,$0.00,$3016.80,Print
5/13/2020,$3.31,$0.00,$3019.54,Print
5/13/2020,$2.76,$0.00,$3022.85,Print
5/13/2020,$2.84,$0.00,$3025.61,Print
5/13/2020,$2.78,$0.00,$3028.45,Print
5/13/2020,$2.74,$0.00,$3031.23,Print
5/13/2020,$4.08,$0.00,$3033.97,Print
5/13/2020,$2.84,$0.00,$3038.05,Print
5/13/2020,$3.21,$0.00,$3040.89,Print
5/13/2020,$2.74,$0.00,$3044.10,Print
5/13/2020,$2.76,$0.00,$3046.84,Print
5/13/2020,$2.76,$0.00,$3049.60,Print
5/13/2020,$3.39,$0.00,$3052.36,Print
5/13/2020,$2.76,$0.00,$3055.75,Print
5/13/2020,$2.74,$0.00,$3058.51,Print
5/13/2020,$3.23,$0.00,$3061.25,Print
5/13/2020,$3.21,$0.00,$3064.48,Print
5/13/2020,$2.84,$0.00,$3067.69,Print
5/13/2020,$3.39,$0.00,$3070.53,Print
5/13/2020,$3.25,$0.00,$3073.92,Print
5/13/2020,$2.76,$0.00,$3077.17,Print
5/13/2020,$3.39,$0.00,$3079.93,Print
5/13/2020,$3.21,$0.00,$3083.32,Print
5/13/2020,$3.31,$0.00,$3086.53,Print
5/13/2020,$5.70,$0.00,$3089.84,Print
5/13/2020,$2.84,$0.00,$3095.54,Print
5/13/2020,$2.74,$0.00,$3098.38,Print
5/13/2020,$3.97,$0.00,$3101.12,Print
5/13/2020,$2.76,$0.00,$3105.09,Print
5/13/2020,$5.70,$0.00,$3107.85,Print
5/13/2020,$3.23,$0.00,$3113.55,Print
5/13/2020,$2.84,$0.00,$3116.78,Print
5/13/2020,$3.31,$0.00,$3119.62,Print
5/13/2020,$3.52,$0.00,$3122.93,Print
5/13/2020,$3.93,$0.00,$3126.45,Print
5/13/2020,$2.84,$0.00,$3130.38,Print
5/13/2020,$2.84,$0.00,$3133.22,Print
5/13/2020,$2.84,$0.00,$3136.06,Print
5/13/2020,$3.31,$0.00,$3138.90,Print
5/13/2020,$3.25,$0.00,$3142.21,Print
5/13/2020,$2.84,$0.00,$3145.46,Print
5/13/2020,$2.78,$0.00,$3148.30,Print
5/13/2020,$4.00,$0.00,$3151.08,Print
5/13/2020,$4.00,$0.00,$3155.08,Print
5/13/2020,$3.31,$0.00,$3159.08,Print
5/13/2020,$2.78,$0.00,$3162.39,Print
5/13/2020,$3.25,$0.00,$3165.17,Print
5/13/2020,$3.39,$0.00,$3168.42,Print
5/13/2020,$2.84,$0.00,$3171.81,Print
5/13/2020,$3.39,$0.00,$3174.65,Print
5/13/2020,$3.25,$0.00,$3178.04,Print
5/13/2020,$3.25,$0.00,$3181.29,Print
5/13/2020,$2.78,$0.00,$3184.54,Print
5/13/2020,$3.25,$0.00,$3187.32,Print
5/13/2020,$5.40,$0.00,$3190.57,Print
5/13/2020,$3.25,$0.00,$3195.97,Print
5/13/2020,$4.00,$0.00,$3199.22,Print
5/13/2020,$3.25,$0.00,$3203.22,Print
5/13/2020,$3.31,$0.00,$3206.47,Print
5/13/2020,$2.93,$0.00,$3209.78,Print
5/13/2020,$3.25,$0.00,$3212.71,Print
5/13/2020,$3.25,$0.00,$3215.96,Print
5/13/2020,$4.32,$0.00,$3219.21,Print
5/13/2020,$2.78,$0.00,$3223.53,Print
5/13/2020,$3.39,$0.00,$3226.31,Print
5/13/2020,$3.25,$0.00,$3229.70,Print
5/13/2020,$2.84,$0.00,$3232.95,Print
5/13/2020,$3.39,$0.00,$3235.79,Print
5/13/2020,$2.76,$0.00,$3239.18,Print
5/13/2020,$3.25,$0.00,$3241.94,Print
5/13/2020,$3.21,$0.00,$3245.19,Print
5/13/2020,$4.00,$0.00,$3248.40,Print
5/13/2020,$2.74,$0.00,$3252.40,Print
5/13/2020,$2.84,$0.00,$3255.14,Print
5/13/2020,$3.25,$0.00,$3257.98,Print
5/13/2020,$2.84,$0.00,$3261.23,Print
5/13/2020,$3.23,$0.00,$3264.07,Print
5/13/2020,$2.84,$0.00,$3267.30,Print
5/13/2020,$2.74,$0.00,$3270.14,Print
5/13/2020,$2.76,$0.00,$3272.88,Print
5/13/2020,$2.76,$0.00,$3275.64,Print
5/13/2020,$7.56,$0.00,$3278.40,Print
5/13/2020,$3.52,$0.00,$3285.96,Print
5/13/2020,$4.08,$0.00,$3289.48,Print
5/13/2020,$2.74,$0.00,$3293.56,Print
5/13/2020,$2.78,$0.00,$3296.30,Print
5/13/2020,$3.25,$0.00,$3299.08,Print
5/13/2020,$3.31,$0.00,$3302.33,Print
5/13/2020,$3.31,$0.00,$3305.64,Print
5/13/2020,$2.93,$0.00,$3308.95,Print
5/13/2020,$2.84,$0.00,$3311.88,Print
5/13/2020,$2.78,$0.00,$3314.72,Print
5/13/2020,$2.84,$0.00,$3317.50,Print
5/13/2020,$2.84,$0.00,$3320.34,Print
5/13/2020,$3.25,$0.00,$3323.18,Print
5/13/2020,$2.84,$0.00,$3326.43,Print
5/13/2020,$2.78,$0.00,$3329.27,Print
5/13/2020,$2.76,$0.00,$3332.05,Print
5/13/2020,$2.76,$0.00,$3334.81,Print
5/13/2020,$2.84,$0.00,$3337.57,Print
5/13/2020,$2.93,$0.00,$3340.41,Print
5/13/2020,$2.78,$0.00,$3343.34,Print
5/13/2020,$2.84,$0.00,$3346.12,Print
5/13/2020,$2.78,$0.00,$3348.96,Print
5/13/2020,$2.78,$0.00,$3351.74,Print
5/13/2020,$2.78,$0.00,$3354.52,Print
5/13/2020,$2.76,$0.00,$3357.30,Print
5/13/2020,$2.78,$0.00,$3360.06,Print
5/13/2020,$2.74,$0.00,$3362.84,Print
5/13/2020,$2.84,$0.00,$3365.58,Print
5/13/2020,$2.84,$0.00,$3368.42,Print
5/13/2020,$2.78,$0.00,$3371.26,Print
5/13/2020,$2.78,$0.00,$3374.04,Print
5/13/2020,$2.84,$0.00,$3376.82,Print
5/13/2020,$2.78,$0.00,$3379.66,Print
5/13/2020,$2.84,$0.00,$3382.44,Print
5/13/2020,$2.78,$0.00,$3385.28,Print
5/13/2020,$2.84,$0.00,$3388.06,Print
5/13/2020,$2.84,$0.00,$3390.90,Print
5/13/2020,$2.78,$0.00,$3393.74,Print
5/13/2020,$2.84,$0.00,$3396.52,Print
5/13/2020,$2.76,$0.00,$3399.36,Print
5/13/2020,$2.84,$0.00,$3402.12,Print
5/13/2020,$2.84,$0.00,$3404.96,Print
5/13/2020,$2.78,$0.00,$3407.80,Print
5/13/2020,$2.76,$0.00,$3410.58,Print
5/13/2020,$7.56,$0.00,$3413.34,Print
5/13/2020,$2.76,$0.00,$3420.90,Print
5/13/2020,$2.84,$0.00,$3423.66,Print
5/13/2020,$2.84,$0.00,$3426.50,Print
5/13/2020,$2.84,$0.00,$3429.34,Print
5/13/2020,$2.93,$0.00,$3432.18,Print
5/13/2020,$2.84,$0.00,$3435.11,Print
5/13/2020,$2.78,$0.00,$3437.95,Print
5/13/2020,$2.76,$0.00,$3440.73,Print
5/13/2020,$2.84,$0.00,$3443.49,Print
5/13/2020,$2.76,$0.00,$3446.33,Print
5/13/2020,$2.74,$0.00,$3449.09,Print
5/13/2020,$2.76,$0.00,$3451.83,Print
5/13/2020,$2.84,$0.00,$3454.59,Print
5/13/2020,$2.84,$0.00,$3457.43,Print
5/13/2020,$2.84,$0.00,$3460.27,Print
5/13/2020,$2.76,$0.00,$3463.11,Print
5/13/2020,$2.76,$0.00,$3465.87,Print
5/13/2020,$2.78,$0.00,$3468.63,Print
5/13/2020,$2.78,$0.00,$3471.41,Print
5/13/2020,$2.84,$0.00,$3474.19,Print
5/13/2020,$2.84,$0.00,$3477.03,Print
5/13/2020,$2.84,$0.00,$3479.87,Print
5/13/2020,$2.78,$0.00,$3482.71,Print
5/13/2020,$2.84,$0.00,$3485.49,Print
5/13/2020,$3.25,$0.00,$3488.33,Print
5/13/2020,$2.84,$0.00,$3491.58,Print
5/13/2020,$2.84,$0.00,$3494.42,Print
5/13/2020,$2.84,$0.00,$3497.26,Print
5/13/2020,$2.78,$0.00,$3500.10,Print
5/13/2020,$2.78,$0.00,$3502.88,Print
5/13/2020,$2.76,$0.00,$3505.66,Print
5/13/2020,$3.97,$0.00,$3508.42,Print
5/13/2020,$2.78,$0.00,$3512.39,Print
5/13/2020,$4.00,$0.00,$3515.17,Print
5/13/2020,$2.84,$0.00,$3519.17,Print
5/13/2020,$2.78,$0.00,$3522.01,Print
5/13/2020,$2.84,$0.00,$3524.79,Print
5/13/2020,$2.78,$0.00,$3527.63,Print
5/13/2020,$2.78,$0.00,$3530.41,Print
5/13/2020,$2.74,$0.00,$3533.19,Print
5/13/2020,$2.84,$0.00,$3535.93,Print
5/13/2020,$2.84,$0.00,$3538.77,Print
5/13/2020,$2.84,$0.00,$3541.61,Print
5/13/2020,$3.23,$0.00,$3544.45,Print
5/13/2020,$2.84,$0.00,$3547.68,Print
5/13/2020,$2.78,$0.00,$3550.52,Print
5/13/2020,$2.78,$0.00,$3553.30,Print
5/13/2020,$2.74,$0.00,$3556.08,Print
5/13/2020,$2.74,$0.00,$3558.82,Print
5/13/2020,$2.84,$0.00,$3561.56,Print
5/13/2020,$2.78,$0.00,$3564.40,Print
5/13/2020,$2.78,$0.00,$3567.18,Print
5/13/2020,$2.84,$0.00,$3569.96,Print
5/13/2020,$3.21,$0.00,$3572.80,Print
5/13/2020,$3.25,$0.00,$3576.01,Print
5/13/2020,$5.12,$0.00,$3579.26,Print
5/13/2020,$2.76,$0.00,$3584.38,Print
5/13/2020,$3.97,$0.00,$3587.14,Print
5/13/2020,$2.74,$0.00,$3591.11,Print
5/13/2020,$2.76,$0.00,$3593.85,Print
5/13/2020,$2.76,$0.00,$3596.61,Print
5/13/2020,$2.84,$0.00,$3599.37,Print
5/13/2020,$2.78,$0.00,$3602.21,Print
5/13/2020,$2.76,$0.00,$3604.99,Print
5/13/2020,$2.84,$0.00,$3607.75,Print
5/13/2020,$2.93,$0.00,$3610.59,Print
5/13/2020,$2.76,$0.00,$3613.52,Print
5/13/2020,$2.78,$0.00,$3616.28,Print
5/13/2020,$2.84,$0.00,$3619.06,Print
5/13/2020,$3.67,$0.00,$3621.90,Print
5/13/2020,$3.31,$0.00,$3625.57,Print
5/13/2020,$2.78,$0.00,$3628.88,Print
5/13/2020,$2.84,$0.00,$3631.66,Print
5/13/2020,$2.84,$0.00,$3634.50,Print
5/13/2020,$2.84,$0.00,$3637.34,Print
5/13/2020,$2.74,$0.00,$3640.18,Print
5/13/2020,$3.21,$0.00,$3642.92,Print
5/13/2020,$3.31,$0.00,$3646.13,Print
5/13/2020,$4.08,$0.00,$3649.44,Print
5/13/2020,$3.31,$0.00,$3653.52,Print
5/13/2020,$4.18,$0.00,$3656.83,Print
5/13/2020,$3.97,$0.00,$3661.01,Print
5/13/2020,$3.21,$0.00,$3664.98,Print
5/13/2020,$4.32,$0.00,$3668.19,Print
5/13/2020,$4.08,$0.00,$3672.51,Print
5/13/2020,$3.97,$0.00,$3676.59,Print
5/13/2020,$3.39,$0.00,$3680.56,Print
5/13/2020,$4.08,$0.00,$3683.95,Print
5/13/2020,$4.46,$0.00,$3688.03,Print
5/13/2020,$3.31,$0.00,$3692.49,Print
5/13/2020,$3.21,$0.00,$3695.80,Print
5/13/2020,$5.04,$0.00,$3699.01,Print
5/13/2020,$2.84,$0.00,$3704.05,Print
5/13/2020,$3.18,$0.00,$3706.89,Print
5/13/2020,$3.21,$0.00,$3710.07,Print
5/13/2020,$2.78,$0.00,$3713.28,Print
5/13/2020,$5.12,$0.00,$3716.06,Print
5/13/2020,$3.25,$0.00,$3721.18,Print
5/13/2020,$2.78,$0.00,$3724.43,Print
5/13/2020,$2.74,$0.00,$3727.21,Print
5/13/2020,$2.78,$0.00,$3729.95,Print
5/13/2020,$3.31,$0.00,$3732.73,Print
5/13/2020,$3.25,$0.00,$3736.04,Print
5/13/2020,$2.74,$0.00,$3739.29,Print
5/13/2020,$5.54,$0.00,$3742.03,Print
5/13/2020,$3.31,$0.00,$3747.57,Print
5/13/2020,$2.78,$0.00,$3750.88,Print
5/13/2020,$3.31,$0.00,$3753.66,Print
5/13/2020,$2.78,$0.00,$3756.97,Print
5/13/2020,$2.78,$0.00,$3759.75,Print
5/13/2020,$2.78,$0.00,$3762.53,Print
5/13/2020,$2.78,$0.00,$3765.31,Print
5/13/2020,$5.27,$0.00,$3768.09,Print
5/13/2020,$3.21,$0.00,$3773.36,Print
5/13/2020,$3.23,$0.00,$3776.57,Print
5/13/2020,$3.67,$0.00,$3779.80,Print
5/13/2020,$3.21,$0.00,$3783.47,Print
5/13/2020,$3.21,$0.00,$3786.68,Print
5/13/2020,$3.31,$0.00,$3789.89,Print
5/13/2020,$3.21,$0.00,$3793.20,Print
5/13/2020,$2.78,$0.00,$3796.41,Print
5/13/2020,$2.78,$0.00,$3799.19,Print
5/13/2020,$3.05,$0.00,$3801.97,Print
5/13/2020,$3.31,$0.00,$3805.02,Print
5/13/2020,$3.31,$0.00,$3808.33,Print
5/13/2020,$3.31,$0.00,$3811.64,Print
5/13/2020,$3.05,$0.00,$3814.95,Print
5/13/2020,$2.84,$0.00,$3818.00,Print
5/13/2020,$3.25,$0.00,$3820.84,Print
5/13/2020,$3.21,$0.00,$3824.09,Print
5/13/2020,$3.21,$0.00,$3827.30,Print
5/13/2020,$3.25,$0.00,$3830.51,Print
5/13/2020,$2.74,$0.00,$3833.76,Print
5/13/2020,$2.78,$0.00,$3836.50,Print
5/13/2020,$3.21,$0.00,$3839.28,Print
5/13/2020,$3.31,$0.00,$3842.49,Print
5/12/2020,$3.21,$0.00,$3845.80,Print
5/12/2020,$3.21,$0.00,$3849.01,Print
5/12/2020,$5.08,$0.00,$3852.22,Print
5/12/2020,$2.76,$0.00,$3857.30,Print
5/12/2020,$3.21,$0.00,$3860.06,Print
5/12/2020,$3.25,$0.00,$3863.27,Print
5/12/2020,$3.21,$0.00,$3866.52,Print
5/12/2020,$2.84,$0.00,$3869.73,Print
5/12/2020,$2.78,$0.00,$3872.57,Print
5/12/2020,$2.78,$0.00,$3875.35,Print
5/12/2020,$3.23,$0.00,$3878.13,Print
5/12/2020,$3.31,$0.00,$3881.36,Print
5/12/2020,$2.76,$0.00,$3884.67,Print
5/12/2020,$2.76,$0.00,$3887.43,Print
5/12/2020,$3.23,$0.00,$3890.19,Print
5/12/2020,$3.21,$0.00,$3893.42,Print
5/12/2020,$3.25,$0.00,$3896.63,Print
5/12/2020,$3.23,$0.00,$3899.88,Print
5/12/2020,$3.97,$0.00,$3903.11,Print
5/12/2020,$3.31,$0.00,$3907.08,Print
5/12/2020,$3.21,$0.00,$3910.39,Print
5/12/2020,$3.23,$0.00,$3913.60,Print
5/12/2020,$3.31,$0.00,$3916.83,Print
5/12/2020,$3.21,$0.00,$3920.14,Print
5/12/2020,$2.74,$0.00,$3923.35,Print
5/12/2020,$3.31,$0.00,$3926.09,Print
5/12/2020,$3.93,$0.00,$3929.40,Print
5/12/2020,$5.12,$0.00,$3933.33,Print
5/12/2020,$3.21,$0.00,$3938.45,Print
5/12/2020,$2.93,$0.00,$3941.66,Print
5/12/2020,$3.25,$0.00,$3944.59,Print
5/12/2020,$3.25,$0.00,$3947.84,Print
5/12/2020,$3.23,$0.00,$3951.09,Print
5/12/2020,$3.21,$0.00,$3954.32,Print
5/12/2020,$4.08,$0.00,$3957.53,Print
5/12/2020,$5.04,$0.00,$3961.61,Print
5/12/2020,$2.84,$0.00,$3966.65,Print
5/12/2020,$3.25,$0.00,$3969.49,Print
5/12/2020,$3.25,$0.00,$3972.74,Print
5/12/2020,$2.78,$0.00,$3975.99,Print
5/12/2020,$2.74,$0.00,$3978.77,Print
5/12/2020,$3.23,$0.00,$3981.51,Print
5/12/2020,$2.78,$0.00,$3984.74,Print
5/12/2020,$2.74,$0.00,$3987.52,Print
5/12/2020,$2.74,$0.00,$3990.26,Print
5/12/2020,$3.31,$0.00,$3993.00,Print
5/12/2020,$2.74,$0.00,$3996.31,Print
5/12/2020,$3.21,$0.00,$3999.05,Print
5/12/2020,$2.84,$0.00,$4002.26,Print
5/12/2020,$3.21,$0.00,$4005.10,Print
5/12/2020,$3.97,$0.00,$4008.31,Print
5/12/2020,$3.31,$0.00,$4012.28,Print
5/12/2020,$2.93,$0.00,$4015.59,Print
5/12/2020,$4.08,$0.00,$4018.52,Print
5/12/2020,$2.78,$0.00,$4022.60,Print
5/12/2020,$3.23,$0.00,$4025.38,Print
5/12/2020,$2.74,$0.00,$4028.61,Print
5/12/2020,$2.84,$0.00,$4031.35,Print
5/12/2020,$3.31,$0.00,$4034.19,Print
5/12/2020,$2.84,$0.00,$4037.50,Print
5/12/2020,$3.23,$0.00,$4040.34,Print
5/12/2020,$3.25,$0.00,$4043.57,Print
5/12/2020,$2.78,$0.00,$4046.82,Print
5/12/2020,$3.21,$0.00,$4049.60,Print
5/12/2020,$2.84,$0.00,$4052.81,Print
5/12/2020,$3.39,$0.00,$4055.65,Print
5/12/2020,$3.31,$0.00,$4059.04,Print
5/12/2020,$3.21,$0.00,$4062.35,Print
5/12/2020,$3.97,$0.00,$4065.56,Print
5/12/2020,$3.21,$0.00,$4069.53,Print
5/12/2020,$3.25,$0.00,$4072.74,Print
5/12/2020,$3.21,$0.00,$4075.99,Print
5/12/2020,$3.21,$0.00,$4079.20,Print
5/12/2020,$3.21,$0.00,$4082.41,Print
5/12/2020,$2.74,$0.00,$4085.62,Print
5/12/2020,$2.76,$0.00,$4088.36,Print
5/12/2020,$5.04,$0.00,$4091.12,Print
5/12/2020,$3.31,$0.00,$4096.16,Print
5/12/2020,$3.31,$0.00,$4099.47,Print
5/12/2020,$3.21,$0.00,$4102.78,Print
5/12/2020,$3.25,$0.00,$4105.99,Print
5/12/2020,$2.76,$0.00,$4109.24,Print
5/12/2020,$2.78,$0.00,$4112.00,Print
5/12/2020,$3.23,$0.00,$4114.78,Print
5/12/2020,$2.76,$0.00,$4118.01,Print
5/12/2020,$3.31,$0.00,$4120.77,Print
5/12/2020,$3.23,$0.00,$4124.08,Print
5/12/2020,$3.31,$0.00,$4127.31,Print
5/12/2020,$3.21,$0.00,$4130.62,Print
5/12/2020,$3.31,$0.00,$4133.83,Print
5/12/2020,$3.25,$0.00,$4137.14,Print
5/12/2020,$3.21,$0.00,$4140.39,Print
5/12/2020,$3.97,$0.00,$4143.60,Print
5/12/2020,$3.21,$0.00,$4147.57,Print
5/12/2020,$3.23,$0.00,$4150.78,Print
5/12/2020,$4.08,$0.00,$4154.01,Print
5/12/2020,$3.21,$0.00,$4158.09,Print
5/12/2020,$3.21,$0.00,$4161.30,Print
5/12/2020,$3.23,$0.00,$4164.51,Print
5/12/2020,$3.25,$0.00,$4167.74,Print
5/12/2020,$3.31,$0.00,$4170.99,Print
5/12/2020,$3.31,$0.00,$4174.30,Print
5/12/2020,$3.23,$0.00,$4177.61,Print
5/12/2020,$3.39,$0.00,$4180.84,Print
5/12/2020,$3.31,$0.00,$4184.23,Print
5/12/2020,$2.78,$0.00,$4187.54,Print
5/12/2020,$2.74,$0.00,$4190.32,Print
5/12/2020,$3.23,$0.00,$4193.06,Print
5/12/2020,$3.93,$0.00,$4196.29,Print
5/12/2020,$3.93,$0.00,$4200.22,Print
5/12/2020,$3.21,$0.00,$4204.15,Print
5/12/2020,$3.21,$0.00,$4207.36,Print
5/12/2020,$3.25,$0.00,$4210.57,Print
5/12/2020,$2.74,$0.00,$4213.82,Print
5/12/2020,$3.21,$0.00,$4216.56,Print
5/12/2020,$2.74,$0.00,$4219.77,Print
5/12/2020,$2.78,$0.00,$4222.51,Print
5/12/2020,$2.78,$0.00,$4225.29,Print
5/12/2020,$2.78,$0.00,$4228.07,Print
5/12/2020,$3.21,$0.00,$4230.85,Print
5/12/2020,$3.23,$0.00,$4234.06,Print
5/12/2020,$3.25,$0.00,$4237.29,Print
5/12/2020,$2.78,$0.00,$4240.54,Print
5/12/2020,$3.21,$0.00,$4243.32,Print
5/12/2020,$2.74,$0.00,$4246.53,Print
5/12/2020,$4.00,$0.00,$4249.27,Print
5/12/2020,$3.97,$0.00,$4253.27,Print
5/12/2020,$3.21,$0.00,$4257.24,Print
5/12/2020,$3.21,$0.00,$4260.45,Print
5/12/2020,$2.78,$0.00,$4263.66,Print
5/12/2020,$3.21,$0.00,$4266.44,Print
5/12/2020,$3.21,$0.00,$4269.65,Print
5/12/2020,$3.23,$0.00,$4272.86,Print
5/12/2020,$3.31,$0.00,$4276.09,Print
5/12/2020,$3.23,$0.00,$4279.40,Print
5/12/2020,$3.21,$0.00,$4282.63,Print
5/12/2020,$3.97,$0.00,$4285.84,Print
5/12/2020,$5.27,$0.00,$4289.81,Print
5/12/2020,$3.25,$0.00,$4295.08,Print
5/12/2020,$3.25,$0.00,$4298.33,Print
5/12/2020,$3.39,$0.00,$4301.58,Print
5/12/2020,$3.23,$0.00,$4304.97,Print
5/12/2020,$3.31,$0.00,$4308.20,Print
5/12/2020,$3.39,$0.00,$4311.51,Print
5/12/2020,$3.23,$0.00,$4314.90,Print
5/12/2020,$3.25,$0.00,$4318.13,Print
5/12/2020,$3.23,$0.00,$4321.38,Print
5/12/2020,$3.23,$0.00,$4324.61,Print
5/12/2020,$3.31,$0.00,$4327.84,Print
5/12/2020,$3.21,$0.00,$4331.15,Print
5/12/2020,$3.23,$0.00,$4334.36,Print
5/12/2020,$3.25,$0.00,$4337.59,Print
5/12/2020,$5.70,$0.00,$4340.84,Print
5/12/2020,$3.25,$0.00,$4346.54,Print
5/12/2020,$3.97,$0.00,$4349.79,Print
5/12/2020,$3.21,$0.00,$4353.76,Print
5/12/2020,$3.25,$0.00,$4356.97,Print
5/12/2020,$3.23,$0.00,$4360.22,Print
5/12/2020,$3.25,$0.00,$4363.45,Print
5/12/2020,$2.78,$0.00,$4366.70,Print
5/12/2020,$3.31,$0.00,$4369.48,Print
5/12/2020,$3.31,$0.00,$4372.79,Print
5/12/2020,$4.08,$0.00,$4376.10,Print
5/12/2020,$3.31,$0.00,$4380.18,Print
5/12/2020,$3.25,$0.00,$4383.49,Print
5/12/2020,$24.18,$0.00,$4386.74,Print
5/12/2020,$3.52,$0.00,$4410.92,Print
5/12/2020,$3.18,$0.00,$4414.44,Print
5/12/2020,$8.76,$0.00,$4417.62,Print
5/12/2020,$2.84,$0.00,$4426.38,Print
5/12/2020,$3.18,$0.00,$4429.22,Print
5/12/2020,$3.52,$0.00,$4432.40,Print
5/12/2020,$43.79,$0.00,$4435.92,Print
5/12/2020,$7.56,$0.00,$4479.71,Print
5/12/2020,$2.74,$0.00,$4487.27,Print
5/12/2020,$4.08,$0.00,$4490.01,Print
5/12/2020,$2.78,$0.00,$4494.09,Print
5/12/2020,$2.78,$0.00,$4496.87,Print
5/12/2020,$2000.00,$0.00,$4499.65,Purchase
5/12/2020,$2.93,$0.00,$2499.65,Print
5/12/2020,$8.76,$0.00,$2502.58,Print
5/12/2020,$2.78,$0.00,$2511.34,Print
5/12/2020,$3.18,$0.00,$2514.12,Print
5/12/2020,$2.78,$0.00,$2517.30,Print
5/12/2020,$2.78,$0.00,$2520.08,Print
5/12/2020,$2.74,$0.00,$2522.86,Print
5/12/2020,$2.78,$0.00,$2525.60,Print
5/12/2020,$2.76,$0.00,$2528.38,Print
5/12/2020,$2.78,$0.00,$2531.14,Print
5/12/2020,$2.84,$0.00,$2533.92,Print
5/12/2020,$2.76,$0.00,$2536.76,Print
5/12/2020,$3.25,$0.00,$2539.52,Print
5/12/2020,$2.74,$0.00,$2542.77,Print
5/12/2020,$2.84,$0.00,$2545.51,Print
5/12/2020,$2.84,$0.00,$2548.35,Print
5/12/2020,$2.78,$0.00,$2551.19,Print
5/12/2020,$2.78,$0.00,$2553.97,Print
5/12/2020,$2.74,$0.00,$2556.75,Print
5/12/2020,$2.84,$0.00,$2559.49,Print
5/12/2020,$2.78,$0.00,$2562.33,Print
5/12/2020,$2.78,$0.00,$2565.11,Print
5/12/2020,$2.84,$0.00,$2567.89,Print
5/12/2020,$2.84,$0.00,$2570.73,Print
5/12/2020,$2.78,$0.00,$2573.57,Print
5/12/2020,$3.25,$0.00,$2576.35,Print
5/12/2020,$5.12,$0.00,$2579.60,Print
5/12/2020,$2.84,$0.00,$2584.72,Print
5/12/2020,$2.74,$0.00,$2587.56,Print
5/12/2020,$2.78,$0.00,$2590.30,Print
5/12/2020,$2.84,$0.00,$2593.08,Print
5/12/2020,$2.74,$0.00,$2595.92,Print
5/12/2020,$2.78,$0.00,$2598.66,Print
5/12/2020,$5.40,$0.00,$2601.44,Print
5/12/2020,$2.84,$0.00,$2606.84,Print
5/12/2020,$3.52,$0.00,$2609.68,Print
5/12/2020,$4.18,$0.00,$2613.20,Print
5/12/2020,$5.12,$0.00,$2617.38,Print
5/12/2020,$5.12,$0.00,$2622.50,Print
5/12/2020,$2.84,$0.00,$2627.62,Print
5/12/2020,$2.84,$0.00,$2630.46,Print
5/12/2020,$2.78,$0.00,$2633.30,Print
5/12/2020,$3.39,$0.00,$2636.08,Print
5/12/2020,$2.84,$0.00,$2639.47,Print
5/12/2020,$2.84,$0.00,$2642.31,Print
5/12/2020,$5.12,$0.00,$2645.15,Print
5/12/2020,$2.76,$0.00,$2650.27,Print
5/12/2020,$9.39,$0.00,$2653.03,Print
5/12/2020,$5.27,$0.00,$2662.42,Print
5/12/2020,$2.84,$0.00,$2667.69,Print
5/12/2020,$2.76,$0.00,$2670.53,Print
5/12/2020,$2.78,$0.00,$2673.29,Print
5/12/2020,$3.39,$0.00,$2676.07,Print
5/12/2020,$3.25,$0.00,$2679.46,Print
5/12/2020,$3.25,$0.00,$2682.71,Print
5/12/2020,$3.21,$0.00,$2685.96,Print
5/12/2020,$3.25,$0.00,$2689.17,Print
5/12/2020,$5.12,$0.00,$2692.42,Print
5/12/2020,$2.78,$0.00,$2697.54,Print
5/12/2020,$2.84,$0.00,$2700.32,Print
5/12/2020,$2.74,$0.00,$2703.16,Print
5/12/2020,$2.78,$0.00,$2705.90,Print
5/12/2020,$3.93,$0.00,$2708.68,Print
5/12/2020,$2.76,$0.00,$2712.61,Print
5/12/2020,$2.78,$0.00,$2715.37,Print
5/12/2020,$3.23,$0.00,$2718.15,Print
5/12/2020,$2.78,$0.00,$2721.38,Print
5/12/2020,$3.25,$0.00,$2724.16,Print
5/12/2020,$2.78,$0.00,$2727.41,Print
5/12/2020,$3.25,$0.00,$2730.19,Print
5/12/2020,$2.78,$0.00,$2733.44,Print
5/12/2020,$2.84,$0.00,$2736.22,Print
5/12/2020,$2.84,$0.00,$2739.06,Print
5/12/2020,$2.78,$0.00,$2741.90,Print
5/12/2020,$2.78,$0.00,$2744.68,Print
5/12/2020,$2.78,$0.00,$2747.46,Print
5/12/2020,$2.74,$0.00,$2750.24,Print
5/12/2020,$2.84,$0.00,$2752.98,Print
5/12/2020,$3.31,$0.00,$2755.82,Print
5/12/2020,$3.21,$0.00,$2759.13,Print
5/12/2020,$2.84,$0.00,$2762.34,Print
5/12/2020,$2.74,$0.00,$2765.18,Print
5/12/2020,$2.78,$0.00,$2767.92,Print
5/12/2020,$3.31,$0.00,$2770.70,Print
5/12/2020,$3.31,$0.00,$2774.01,Print
5/12/2020,$2.76,$0.00,$2777.32,Print
5/12/2020,$2.78,$0.00,$2780.08,Print
5/12/2020,$2.84,$0.00,$2782.86,Print
5/12/2020,$2.84,$0.00,$2785.70,Print
5/12/2020,$3.25,$0.00,$2788.54,Print
5/12/2020,$3.25,$0.00,$2791.79,Print
5/12/2020,$3.31,$0.00,$2795.04,Print
5/12/2020,$3.25,$0.00,$2798.35,Print
5/12/2020,$3.21,$0.00,$2801.60,Print
5/12/2020,$2.84,$0.00,$2804.81,Print
5/12/2020,$3.21,$0.00,$2807.65,Print
5/12/2020,$3.23,$0.00,$2810.86,Print
5/12/2020,$3.25,$0.00,$2814.09,Print
5/12/2020,$3.23,$0.00,$2817.34,Print
5/12/2020,$3.25,$0.00,$2820.57,Print
5/12/2020,$3.31,$0.00,$2823.82,Print
5/12/2020,$3.25,$0.00,$2827.13,Print
5/12/2020,$2.93,$0.00,$2830.38,Print
5/12/2020,$2.78,$0.00,$2833.31,Print
5/12/2020,$3.25,$0.00,$2836.09,Print
5/12/2020,$3.23,$0.00,$2839.34,Print
5/12/2020,$2.78,$0.00,$2842.57,Print
5/12/2020,$2.84,$0.00,$2845.35,Print
5/12/2020,$3.25,$0.00,$2848.19,Print
5/12/2020,$3.31,$0.00,$2851.44,Print
5/12/2020,$3.52,$0.00,$2854.75,Print
5/12/2020,$3.31,$0.00,$2858.27,Print
5/12/2020,$4.00,$0.00,$2861.58,Print
5/12/2020,$3.25,$0.00,$2865.58,Print
5/12/2020,$3.25,$0.00,$2868.83,Print
5/12/2020,$3.25,$0.00,$2872.08,Print
5/12/2020,$3.31,$0.00,$2875.33,Print
5/12/2020,$3.31,$0.00,$2878.64,Print
5/12/2020,$3.21,$0.00,$2881.95,Print
5/12/2020,$3.23,$0.00,$2885.16,Print
5/12/2020,$3.39,$0.00,$2888.39,Print
5/12/2020,$4.00,$0.00,$2891.78,Print
5/12/2020,$3.52,$0.00,$2895.78,Print
5/12/2020,$3.23,$0.00,$2899.30,Print
5/12/2020,$3.25,$0.00,$2902.53,Print
5/12/2020,$4.32,$0.00,$2905.78,Print
5/12/2020,$3.25,$0.00,$2910.10,Print
5/12/2020,$3.93,$0.00,$2913.35,Print
5/12/2020,$3.25,$0.00,$2917.28,Print
5/12/2020,$3.67,$0.00,$2920.53,Print
5/12/2020,$3.21,$0.00,$2924.20,Print
5/12/2020,$4.32,$0.00,$2927.41,Print
5/12/2020,$4.00,$0.00,$2931.73,Print
5/12/2020,$5.40,$0.00,$2935.73,Print
5/12/2020,$3.31,$0.00,$2941.13,Print
5/12/2020,$3.25,$0.00,$2944.44,Print
5/12/2020,$5.08,$0.00,$2947.69,Print
5/12/2020,$3.25,$0.00,$2952.77,Print
5/12/2020,$2.76,$0.00,$2956.02,Print
5/12/2020,$3.21,$0.00,$2958.78,Print
5/12/2020,$4.00,$0.00,$2961.99,Print
5/12/2020,$2.74,$0.00,$2965.99,Print
5/12/2020,$2.76,$0.00,$2968.73,Print
5/12/2020,$3.25,$0.00,$2971.49,Print
5/12/2020,$5.08,$0.00,$2974.74,Print
5/12/2020,$4.00,$0.00,$2979.82,Print
5/12/2020,$2.74,$0.00,$2983.82,Print
5/12/2020,$2.78,$0.00,$2986.56,Print
5/12/2020,$3.52,$0.00,$2989.34,Print
5/12/2020,$3.39,$0.00,$2992.86,Print
5/12/2020,$2.74,$0.00,$2996.25,Print
5/12/2020,$3.52,$0.00,$2998.99,Print
5/12/2020,$3.39,$0.00,$3002.51,Print
5/12/2020,$2.74,$0.00,$3005.90,Print
5/12/2020,$2.84,$0.00,$3008.64,Print
5/12/2020,$3.21,$0.00,$3011.48,Print
5/12/2020,$2.76,$0.00,$3014.69,Print
5/12/2020,$2.78,$0.00,$3017.45,Print
5/12/2020,$2.84,$0.00,$3020.23,Print
5/12/2020,$2.78,$0.00,$3023.07,Print
5/12/2020,$2.84,$0.00,$3025.85,Print
5/12/2020,$2.76,$0.00,$3028.69,Print
5/12/2020,$4.00,$0.00,$3031.45,Print
5/12/2020,$4.00,$0.00,$3035.45,Print
5/12/2020,$3.05,$0.00,$3039.45,Print
5/12/2020,$3.52,$0.00,$3042.50,Print
5/12/2020,$3.23,$0.00,$3046.02,Print
5/12/2020,$3.31,$0.00,$3049.25,Print
5/12/2020,$3.25,$0.00,$3052.56,Print
5/12/2020,$2.78,$0.00,$3055.81,Print
5/12/2020,$3.21,$0.00,$3058.59,Print
5/12/2020,$3.21,$0.00,$3061.80,Print
5/12/2020,$3.25,$0.00,$3065.01,Print
5/12/2020,$3.25,$0.00,$3068.26,Print
5/12/2020,$3.31,$0.00,$3071.51,Print
5/12/2020,$3.21,$0.00,$3074.82,Print
5/12/2020,$3.39,$0.00,$3078.03,Print
5/12/2020,$2.76,$0.00,$3081.42,Print
5/12/2020,$2.74,$0.00,$3084.18,Print
5/12/2020,$2.76,$0.00,$3086.92,Print
5/12/2020,$3.25,$0.00,$3089.68,Print
5/12/2020,$2.84,$0.00,$3092.93,Print
5/12/2020,$3.23,$0.00,$3095.77,Print
5/12/2020,$3.25,$0.00,$3099.00,Print
5/12/2020,$3.21,$0.00,$3102.25,Print
5/12/2020,$3.23,$0.00,$3105.46,Print
5/12/2020,$3.23,$0.00,$3108.69,Print
5/12/2020,$4.00,$0.00,$3111.92,Print
5/12/2020,$5.08,$0.00,$3115.92,Print
5/12/2020,$5.27,$0.00,$3121.00,Print
5/12/2020,$3.39,$0.00,$3126.27,Print
5/12/2020,$4.00,$0.00,$3129.66,Print
5/12/2020,$3.18,$0.00,$3133.66,Print
5/12/2020,$3.52,$0.00,$3136.84,Print
5/12/2020,$2.74,$0.00,$3140.36,Print
5/12/2020,$2.74,$0.00,$3143.10,Print
5/12/2020,$2.76,$0.00,$3145.84,Print
5/12/2020,$2.78,$0.00,$3148.60,Print
5/12/2020,$2.78,$0.00,$3151.38,Print
5/12/2020,$2.84,$0.00,$3154.16,Print
5/12/2020,$2.74,$0.00,$3157.00,Print
5/12/2020,$2.84,$0.00,$3159.74,Print
5/12/2020,$2.76,$0.00,$3162.58,Print
5/12/2020,$2.84,$0.00,$3165.34,Print
5/12/2020,$2.74,$0.00,$3168.18,Print
5/12/2020,$5.12,$0.00,$3170.92,Print
5/12/2020,$3.31,$0.00,$3176.04,Print
5/12/2020,$2.74,$0.00,$3179.35,Print
5/12/2020,$2.78,$0.00,$3182.09,Print
5/12/2020,$2.84,$0.00,$3184.87,Print
5/12/2020,$5.08,$0.00,$3187.71,Print
5/12/2020,$3.05,$0.00,$3192.79,Print
5/12/2020,$5.08,$0.00,$3195.84,Print
5/12/2020,$3.25,$0.00,$3200.92,Print
5/12/2020,$2.84,$0.00,$3204.17,Print
5/12/2020,$3.23,$0.00,$3207.01,Print
5/12/2020,$2.84,$0.00,$3210.24,Print
5/12/2020,$2.84,$0.00,$3213.08,Print
5/12/2020,$2.76,$0.00,$3215.92,Print
5/12/2020,$2.84,$0.00,$3218.68,Print
5/12/2020,$2.76,$0.00,$3221.52,Print
5/12/2020,$3.31,$0.00,$3224.28,Print
5/12/2020,$2.84,$0.00,$3227.59,Print
5/12/2020,$2.74,$0.00,$3230.43,Print
5/12/2020,$2.76,$0.00,$3233.17,Print
5/12/2020,$2.76,$0.00,$3235.93,Print
5/12/2020,$2.74,$0.00,$3238.69,Print
5/12/2020,$2.84,$0.00,$3241.43,Print
5/12/2020,$3.25,$0.00,$3244.27,Print
5/12/2020,$3.31,$0.00,$3247.52,Print
5/12/2020,$4.08,$0.00,$3250.83,Print
5/12/2020,$2.84,$0.00,$3254.91,Print
5/12/2020,$3.52,$0.00,$3257.75,Print
5/12/2020,$3.25,$0.00,$3261.27,Print
5/12/2020,$3.31,$0.00,$3264.52,Print
5/12/2020,$3.31,$0.00,$3267.83,Print
5/12/2020,$2.76,$0.00,$3271.14,Print
5/12/2020,$2.84,$0.00,$3273.90,Print
5/12/2020,$2.74,$0.00,$3276.74,Print
5/12/2020,$2.74,$0.00,$3279.48,Print
5/12/2020,$2.84,$0.00,$3282.22,Print
5/12/2020,$2.84,$0.00,$3285.06,Print
5/12/2020,$2.78,$0.00,$3287.90,Print
5/12/2020,$2.84,$0.00,$3290.68,Print
5/12/2020,$2.84,$0.00,$3293.52,Print
5/12/2020,$2.76,$0.00,$3296.36,Print
5/12/2020,$2.78,$0.00,$3299.12,Print
5/12/2020,$2.78,$0.00,$3301.90,Print
5/12/2020,$2.74,$0.00,$3304.68,Print
5/12/2020,$2.84,$0.00,$3307.42,Print
5/12/2020,$2.76,$0.00,$3310.26,Print
5/12/2020,$3.97,$0.00,$3313.02,Print
5/12/2020,$2.84,$0.00,$3316.99,Print
5/12/2020,$2.74,$0.00,$3319.83,Print
5/12/2020,$2.78,$0.00,$3322.57,Print
5/12/2020,$2.78,$0.00,$3325.35,Print
5/12/2020,$2.78,$0.00,$3328.13,Print
5/12/2020,$3.05,$0.00,$3330.91,Print
5/12/2020,$2.84,$0.00,$3333.96,Print
5/12/2020,$3.25,$0.00,$3336.80,Print
5/12/2020,$2.84,$0.00,$3340.05,Print
5/12/2020,$2.78,$0.00,$3342.89,Print
5/12/2020,$2.76,$0.00,$3345.67,Print
5/12/2020,$0.00,$3.31,$3348.43,Credit
5/12/2020,$2.84,$0.00,$3345.12,Print
5/12/2020,$2.78,$0.00,$3347.96,Print
5/12/2020,$3.25,$0.00,$3350.74,Print
5/12/2020,$2.76,$0.00,$3353.99,Print
5/12/2020,$2.74,$0.00,$3356.75,Print
5/12/2020,$2.84,$0.00,$3359.49,Print
5/12/2020,$5.70,$0.00,$3362.33,Print
5/12/2020,$3.25,$0.00,$3368.03,Print
5/12/2020,$2.78,$0.00,$3371.28,Print
5/12/2020,$2.84,$0.00,$3374.06,Print
5/12/2020,$2.78,$0.00,$3376.90,Print
5/12/2020,$2.78,$0.00,$3379.68,Print
5/12/2020,$2.74,$0.00,$3382.46,Print
5/12/2020,$2.84,$0.00,$3385.20,Print
5/12/2020,$2.76,$0.00,$3388.04,Print
5/12/2020,$2.84,$0.00,$3390.80,Print
5/12/2020,$2.84,$0.00,$3393.64,Print
5/12/2020,$2.78,$0.00,$3396.48,Print
5/12/2020,$3.31,$0.00,$3399.26,Print
5/12/2020,$3.05,$0.00,$3402.57,Print
5/12/2020,$2.76,$0.00,$3405.62,Print
5/12/2020,$2.74,$0.00,$3408.38,Print
5/12/2020,$3.25,$0.00,$3411.12,Print
5/12/2020,$2.76,$0.00,$3414.37,Print
5/12/2020,$2.78,$0.00,$3417.13,Print
5/12/2020,$3.52,$0.00,$3419.91,Print
5/12/2020,$2.84,$0.00,$3423.43,Print
5/12/2020,$2.76,$0.00,$3426.27,Print
5/12/2020,$2.84,$0.00,$3429.03,Print
5/12/2020,$2.84,$0.00,$3431.87,Print
5/12/2020,$2.93,$0.00,$3434.71,Print
5/12/2020,$5.40,$0.00,$3437.64,Print
5/12/2020,$2.84,$0.00,$3443.04,Print
5/12/2020,$3.67,$0.00,$3445.88,Print
5/12/2020,$3.25,$0.00,$3449.55,Print
5/12/2020,$2.74,$0.00,$3452.80,Print
5/12/2020,$2.84,$0.00,$3455.54,Print
5/12/2020,$2.76,$0.00,$3458.38,Print
5/12/2020,$2.76,$0.00,$3461.14,Print
5/12/2020,$2.84,$0.00,$3463.90,Print
5/12/2020,$5.70,$0.00,$3466.74,Print
5/12/2020,$2.84,$0.00,$3472.44,Print
5/12/2020,$3.05,$0.00,$3475.28,Print
5/12/2020,$2.84,$0.00,$3478.33,Print
5/12/2020,$3.25,$0.00,$3481.17,Print
5/12/2020,$2.84,$0.00,$3484.42,Print
5/12/2020,$3.21,$0.00,$3487.26,Print
5/12/2020,$2.84,$0.00,$3490.47,Print
5/12/2020,$2.78,$0.00,$3493.31,Print
5/12/2020,$2.84,$0.00,$3496.09,Print
5/12/2020,$2.93,$0.00,$3498.93,Print
5/12/2020,$2.84,$0.00,$3501.86,Print
5/12/2020,$5.04,$0.00,$3504.70,Print
5/12/2020,$2.84,$0.00,$3509.74,Print
5/12/2020,$2.84,$0.00,$3512.58,Print
5/12/2020,$5.27,$0.00,$3515.42,Print
5/12/2020,$2.76,$0.00,$3520.69,Print
5/12/2020,$5.04,$0.00,$3523.45,Print
5/12/2020,$3.31,$0.00,$3528.49,Print
5/12/2020,$3.23,$0.00,$3531.80,Print
5/12/2020,$2.74,$0.00,$3535.03,Print
5/12/2020,$2.78,$0.00,$3537.77,Print
5/12/2020,$2.78,$0.00,$3540.55,Print
5/12/2020,$3.25,$0.00,$3543.33,Print
5/12/2020,$3.21,$0.00,$3546.58,Print
5/12/2020,$3.25,$0.00,$3549.79,Print
5/12/2020,$2.84,$0.00,$3553.04,Print
5/12/2020,$2.84,$0.00,$3555.88,Print
5/12/2020,$2.84,$0.00,$3558.72,Print
5/12/2020,$2.84,$0.00,$3560.37,Print
5/12/2020,$2.74,$0.00,$3563.21,Print
5/12/2020,$2.78,$0.00,$3565.95,Print
5/12/2020,$2.76,$0.00,$3568.73,Print
5/12/2020,$2.78,$0.00,$3571.49,Print
5/12/2020,$2.84,$0.00,$3574.27,Print
5/12/2020,$2.76,$0.00,$3577.11,Print
5/12/2020,$2.84,$0.00,$3579.87,Print
5/12/2020,$2.84,$0.00,$3582.71,Print
5/12/2020,$2.76,$0.00,$3585.55,Print
5/12/2020,$2.84,$0.00,$3588.31,Print
5/12/2020,$2.84,$0.00,$3591.15,Print
5/12/2020,$3.97,$0.00,$3593.99,Print
5/12/2020,$8.42,$0.00,$3597.96,Print
5/11/2020,$24.18,$0.00,$3606.38,Print
5/11/2020,$3.21,$0.00,$3630.56,Print
5/11/2020,$3.25,$0.00,$3633.77,Print
5/11/2020,$7.02,$0.00,$3637.02,Print
5/11/2020,$2.74,$0.00,$3644.04,Print
5/11/2020,$3.21,$0.00,$3646.78,Print
5/11/2020,$2.78,$0.00,$3649.99,Print
5/11/2020,$2.74,$0.00,$3652.77,Print
5/11/2020,$2.74,$0.00,$3655.51,Print
5/11/2020,$2.74,$0.00,$3658.25,Print
5/11/2020,$2.74,$0.00,$3660.99,Print
5/11/2020,$2.78,$0.00,$3663.73,Print
5/11/2020,$2.74,$0.00,$3666.51,Print
5/11/2020,$2.74,$0.00,$3669.25,Print
5/11/2020,$3.25,$0.00,$3671.99,Print
5/11/2020,$5.27,$0.00,$3675.24,Print
5/11/2020,$5.27,$0.00,$3680.51,Print
5/11/2020,$2.74,$0.00,$3685.78,Print
5/11/2020,$3.25,$0.00,$3688.52,Print
5/11/2020,$2.74,$0.00,$3691.77,Print
5/11/2020,$3.05,$0.00,$3694.51,Print
5/11/2020,$2.84,$0.00,$3697.56,Print
5/11/2020,$2.74,$0.00,$3700.40,Print
5/11/2020,$3.05,$0.00,$3703.14,Print
5/11/2020,$3.23,$0.00,$3706.19,Print
5/11/2020,$5.27,$0.00,$3709.42,Print
5/11/2020,$2.78,$0.00,$3714.69,Print
5/11/2020,$3.21,$0.00,$3717.47,Print
5/11/2020,$5.04,$0.00,$3720.68,Print
5/11/2020,$3.25,$0.00,$3725.72,Print
5/11/2020,$2.76,$0.00,$3728.97,Print
5/11/2020,$2.74,$0.00,$3731.73,Print
5/11/2020,$5.40,$0.00,$3734.47,Print
5/11/2020,$3.97,$0.00,$3739.87,Print
5/11/2020,$2.74,$0.00,$3743.84,Print
5/11/2020,$4.32,$0.00,$3746.58,Print
5/11/2020,$3.25,$0.00,$3750.90,Print
5/11/2020,$2.84,$0.00,$3754.15,Print
5/11/2020,$7.84,$0.00,$3756.99,Print
5/11/2020,$4.00,$0.00,$3764.83,Print
5/11/2020,$2.78,$0.00,$3768.83,Print
5/11/2020,$3.93,$0.00,$3771.61,Print
5/11/2020,$3.25,$0.00,$3775.54,Print
5/11/2020,$3.52,$0.00,$3778.79,Print
5/11/2020,$2.76,$0.00,$3782.31,Print
5/11/2020,$2.78,$0.00,$3785.07,Print
5/11/2020,$2.76,$0.00,$3787.85,Print
5/11/2020,$3.21,$0.00,$3790.61,Print
5/11/2020,$2.78,$0.00,$3793.82,Print
5/11/2020,$2.84,$0.00,$3796.60,Print
5/11/2020,$2.84,$0.00,$3799.44,Print
5/11/2020,$3.23,$0.00,$3802.28,Print
5/11/2020,$2.84,$0.00,$3805.51,Print
5/11/2020,$5.12,$0.00,$3808.35,Print
5/11/2020,$3.21,$0.00,$3813.47,Print
5/11/2020,$2.78,$0.00,$3816.68,Print
5/11/2020,$2.78,$0.00,$3819.46,Print
5/11/2020,$2.78,$0.00,$3822.24,Print
5/11/2020,$2.76,$0.00,$3825.02,Print
5/11/2020,$2.84,$0.00,$3827.78,Print
5/11/2020,$2.84,$0.00,$3830.62,Print
5/11/2020,$2.78,$0.00,$3833.46,Print
5/11/2020,$2.84,$0.00,$3836.24,Print
5/11/2020,$5.54,$0.00,$3839.08,Print
5/11/2020,$2.74,$0.00,$3844.62,Print
5/11/2020,$2.93,$0.00,$3847.36,Print
5/11/2020,$2.84,$0.00,$3850.29,Print
5/11/2020,$2.78,$0.00,$3853.13,Print
5/11/2020,$3.31,$0.00,$3855.91,Print
5/11/2020,$3.23,$0.00,$3859.22,Print
5/11/2020,$2.76,$0.00,$3862.45,Print
5/11/2020,$2.74,$0.00,$3865.21,Print
5/11/2020,$2.84,$0.00,$3867.95,Print
5/11/2020,$2.78,$0.00,$3870.79,Print
5/11/2020,$2.93,$0.00,$3873.57,Print
5/11/2020,$2.78,$0.00,$3876.50,Print
5/11/2020,$2.84,$0.00,$3879.28,Print
5/11/2020,$2.78,$0.00,$3882.12,Print
5/11/2020,$2.76,$0.00,$3884.90,Print
5/11/2020,$5.08,$0.00,$3887.66,Print
5/11/2020,$3.25,$0.00,$3892.74,Print
5/11/2020,$2.74,$0.00,$3895.99,Print
5/11/2020,$2.74,$0.00,$3898.73,Print
5/11/2020,$2.84,$0.00,$3901.47,Print
5/11/2020,$2.76,$0.00,$3904.31,Print
5/11/2020,$3.31,$0.00,$3907.07,Print
5/11/2020,$2.78,$0.00,$3910.38,Print
5/11/2020,$3.05,$0.00,$3913.16,Print
5/11/2020,$2.76,$0.00,$3916.21,Print
5/11/2020,$2.78,$0.00,$3918.97,Print
5/11/2020,$3.31,$0.00,$3921.75,Print
5/11/2020,$2.78,$0.00,$3925.06,Print
5/11/2020,$3.31,$0.00,$3927.84,Print
5/11/2020,$3.05,$0.00,$3931.15,Print
5/11/2020,$2.84,$0.00,$3934.20,Print
5/11/2020,$3.52,$0.00,$3937.04,Print
5/11/2020,$2.78,$0.00,$3940.56,Print
5/11/2020,$3.25,$0.00,$3943.34,Print
5/11/2020,$2.76,$0.00,$3946.59,Print
5/11/2020,$2.84,$0.00,$3949.35,Print
5/11/2020,$3.31,$0.00,$3952.19,Print
5/11/2020,$2.84,$0.00,$3955.50,Print
5/11/2020,$2.78,$0.00,$3958.34,Print
5/11/2020,$2.84,$0.00,$3961.12,Print
5/11/2020,$2.84,$0.00,$3963.96,Print
5/11/2020,$2.84,$0.00,$3966.80,Print
5/11/2020,$3.25,$0.00,$3969.64,Print
5/11/2020,$2.74,$0.00,$3972.89,Print
5/11/2020,$2.76,$0.00,$3975.63,Print
5/11/2020,$3.25,$0.00,$3978.39,Print
5/11/2020,$4.08,$0.00,$3981.64,Print
5/11/2020,$2.76,$0.00,$3985.72,Print
5/11/2020,$7.98,$0.00,$3988.48,Print
5/11/2020,$2.76,$0.00,$3996.46,Print
5/11/2020,$3.31,$0.00,$3999.22,Print
5/11/2020,$2.74,$0.00,$4002.53,Print
5/11/2020,$3.25,$0.00,$4005.27,Print
5/11/2020,$2.93,$0.00,$4008.52,Print
5/11/2020,$2.93,$0.00,$4011.45,Print
5/11/2020,$2.78,$0.00,$4014.38,Print
5/11/2020,$2.74,$0.00,$4017.16,Print
5/11/2020,$5.54,$0.00,$4019.90,Print
5/11/2020,$3.31,$0.00,$4025.44,Print
5/11/2020,$3.31,$0.00,$4028.75,Print
5/11/2020,$5.04,$0.00,$4032.06,Print
5/11/2020,$2.78,$0.00,$4037.10,Print
5/11/2020,$3.93,$0.00,$4039.88,Print
5/11/2020,$2.78,$0.00,$4043.81,Print
5/11/2020,$2.76,$0.00,$4046.59,Print
5/11/2020,$2.76,$0.00,$4049.35,Print
5/11/2020,$2.76,$0.00,$4052.11,Print
5/11/2020,$2.78,$0.00,$4054.87,Print
5/11/2020,$2.78,$0.00,$4057.65,Print
5/11/2020,$3.52,$0.00,$4060.43,Print
5/11/2020,$2.84,$0.00,$4063.95,Print
5/11/2020,$2.78,$0.00,$4066.79,Print
5/11/2020,$3.31,$0.00,$4069.57,Print
5/11/2020,$3.23,$0.00,$4072.88,Print
5/11/2020,$2.74,$0.00,$4076.11,Print
5/11/2020,$3.21,$0.00,$4078.85,Print
5/11/2020,$2.74,$0.00,$4082.06,Print
5/11/2020,$2.76,$0.00,$4084.80,Print
5/11/2020,$2.78,$0.00,$4087.56,Print
5/11/2020,$3.21,$0.00,$4090.34,Print
5/11/2020,$2.76,$0.00,$4093.55,Print
5/11/2020,$2.78,$0.00,$4096.31,Print
5/11/2020,$2.84,$0.00,$4099.09,Print
5/11/2020,$35.01,$0.00,$4101.93,Print
5/11/2020,$2.74,$0.00,$4136.94,Print
5/11/2020,$5.54,$0.00,$4139.68,Print
5/11/2020,$3.67,$0.00,$4145.22,Print
5/11/2020,$2.74,$0.00,$4148.89,Print
5/11/2020,$2.78,$0.00,$4151.63,Print
5/11/2020,$2.76,$0.00,$4154.41,Print
5/11/2020,$3.25,$0.00,$4157.17,Print
5/11/2020,$3.31,$0.00,$4160.42,Print
5/11/2020,$2.76,$0.00,$4163.73,Print
5/11/2020,$3.39,$0.00,$4166.49,Print
5/11/2020,$3.31,$0.00,$4169.88,Print
5/11/2020,$3.31,$0.00,$4173.19,Print
5/11/2020,$3.25,$0.00,$4176.50,Print
5/11/2020,$2.76,$0.00,$4179.75,Print
5/11/2020,$3.31,$0.00,$4182.51,Print
5/11/2020,$5.12,$0.00,$4185.82,Print
5/11/2020,$2.78,$0.00,$4190.94,Print
5/11/2020,$3.23,$0.00,$4193.72,Print
5/11/2020,$2.78,$0.00,$4196.95,Print
5/11/2020,$3.39,$0.00,$4199.73,Print
5/11/2020,$2.78,$0.00,$4203.12,Print
5/11/2020,$2.74,$0.00,$4205.90,Print
5/11/2020,$5.12,$0.00,$4208.64,Print
5/11/2020,$2.78,$0.00,$4213.76,Print
5/11/2020,$3.21,$0.00,$4216.54,Print
5/11/2020,$2.84,$0.00,$4219.75,Print
5/11/2020,$3.25,$0.00,$4222.59,Print
5/11/2020,$2.78,$0.00,$4225.84,Print
5/11/2020,$3.21,$0.00,$4228.62,Print
5/11/2020,$2.78,$0.00,$4231.83,Print
5/11/2020,$2.84,$0.00,$4234.61,Print
5/11/2020,$3.21,$0.00,$4237.45,Print
5/11/2020,$3.25,$0.00,$4240.66,Print
5/11/2020,$4.18,$0.00,$4243.91,Print
5/11/2020,$3.31,$0.00,$4248.09,Print
5/11/2020,$4.00,$0.00,$4251.40,Print
5/11/2020,$3.52,$0.00,$4255.40,Print
5/11/2020,$2.84,$0.00,$4258.92,Print
5/11/2020,$3.21,$0.00,$4261.76,Print
5/11/2020,$4.18,$0.00,$4264.97,Print
5/11/2020,$4.00,$0.00,$4269.15,Print
5/11/2020,$2.74,$0.00,$4273.15,Print
5/11/2020,$4.08,$0.00,$4275.89,Print
5/11/2020,$4.18,$0.00,$4279.97,Print
5/11/2020,$4.32,$0.00,$4284.15,Print
5/11/2020,$3.52,$0.00,$4288.47,Print
5/11/2020,$4.32,$0.00,$4291.99,Print
5/11/2020,$4.32,$0.00,$4296.31,Print
5/11/2020,$3.05,$0.00,$4300.63,Print
5/11/2020,$3.25,$0.00,$4303.68,Print
5/11/2020,$3.25,$0.00,$4306.93,Print
5/11/2020,$4.00,$0.00,$4310.18,Print
5/11/2020,$4.18,$0.00,$4314.18,Print
5/11/2020,$4.18,$0.00,$4318.36,Print
5/11/2020,$4.32,$0.00,$4322.54,Print
5/11/2020,$3.21,$0.00,$4326.86,Print
5/11/2020,$3.21,$0.00,$4330.07,Print
5/11/2020,$7.80,$0.00,$4333.28,Print
5/11/2020,$4.08,$0.00,$4341.08,Print
5/11/2020,$3.31,$0.00,$4345.16,Print
5/11/2020,$3.21,$0.00,$4348.47,Print
5/11/2020,$3.31,$0.00,$4351.68,Print
5/11/2020,$5.12,$0.00,$4354.99,Print
5/11/2020,$5.12,$0.00,$4360.11,Print
5/11/2020,$3.25,$0.00,$4365.23,Print
5/11/2020,$5.04,$0.00,$4368.48,Print
5/11/2020,$5.04,$0.00,$4373.52,Print
5/11/2020,$4.32,$0.00,$4378.56,Print
5/11/2020,$3.18,$0.00,$4382.88,Print
5/11/2020,$4.08,$0.00,$4386.06,Print
5/11/2020,$3.21,$0.00,$4390.14,Print
5/11/2020,$3.21,$0.00,$4393.35,Print
5/11/2020,$4.08,$0.00,$4396.56,Print
5/11/2020,$2.76,$0.00,$4400.64,Print
5/11/2020,$3.52,$0.00,$4403.40,Print
5/11/2020,$3.05,$0.00,$4406.92,Print
5/11/2020,$3.23,$0.00,$4409.97,Print
5/11/2020,$26.57,$0.00,$4413.20,Print
5/11/2020,$2.74,$0.00,$4439.77,Print
5/11/2020,$3.31,$0.00,$4442.51,Print
5/11/2020,$3.25,$0.00,$4445.82,Print
5/11/2020,$3.25,$0.00,$4449.07,Print
5/11/2020,$2.78,$0.00,$4452.32,Print
5/11/2020,$3.25,$0.00,$4455.10,Print
5/11/2020,$3.31,$0.00,$4458.35,Print
5/11/2020,$2.74,$0.00,$4461.66,Print
5/11/2020,$3.25,$0.00,$4464.40,Print
5/11/2020,$5.12,$0.00,$4467.65,Print
5/11/2020,$8.12,$0.00,$4472.77,Print
5/11/2020,$5.08,$0.00,$4480.89,Print
5/11/2020,$12.15,$0.00,$4485.97,Print
5/11/2020,$2000.00,$0.00,$4498.12,Purchase
5/11/2020,$2.84,$0.00,$2498.12,Print
5/11/2020,$3.25,$0.00,$2500.96,Print
5/11/2020,$3.25,$0.00,$2504.21,Print
5/11/2020,$2.74,$0.00,$2507.46,Print
5/11/2020,$2.74,$0.00,$2510.20,Print
5/11/2020,$2.78,$0.00,$2512.94,Print
5/11/2020,$7.56,$0.00,$2515.72,Print
5/11/2020,$2.74,$0.00,$2523.28,Print
5/11/2020,$2.78,$0.00,$2526.02,Print
5/11/2020,$2.78,$0.00,$2528.80,Print
5/11/2020,$3.25,$0.00,$2531.58,Print
5/11/2020,$3.31,$0.00,$2534.83,Print
5/11/2020,$3.67,$0.00,$2538.14,Print
5/11/2020,$3.25,$0.00,$2541.81,Print
5/11/2020,$2.78,$0.00,$2545.06,Print
5/11/2020,$3.23,$0.00,$2547.84,Print
5/11/2020,$2.74,$0.00,$2551.07,Print
5/11/2020,$2.78,$0.00,$2553.81,Print
5/11/2020,$2.74,$0.00,$2556.59,Print
5/11/2020,$2.74,$0.00,$2559.33,Print
5/11/2020,$2.78,$0.00,$2562.07,Print
5/11/2020,$2.76,$0.00,$2564.85,Print
5/11/2020,$2.74,$0.00,$2567.61,Print
5/11/2020,$2.78,$0.00,$2570.35,Print
5/11/2020,$2.74,$0.00,$2573.13,Print
5/11/2020,$2.74,$0.00,$2575.87,Print
5/11/2020,$2.76,$0.00,$2578.61,Print
5/11/2020,$2.93,$0.00,$2581.37,Print
5/11/2020,$4.00,$0.00,$2584.30,Print
5/11/2020,$2.74,$0.00,$2588.30,Print
5/11/2020,$2.78,$0.00,$2591.04,Print
5/11/2020,$2.74,$0.00,$2593.82,Print
5/11/2020,$3.21,$0.00,$2596.56,Print
5/11/2020,$3.23,$0.00,$2599.77,Print
5/11/2020,$2.78,$0.00,$2603.00,Print
5/11/2020,$3.18,$0.00,$2605.78,Print
5/11/2020,$2.78,$0.00,$2608.96,Print
5/11/2020,$2.76,$0.00,$2611.74,Print
5/11/2020,$4.08,$0.00,$2614.50,Print
5/11/2020,$4.00,$0.00,$2618.58,Print
5/11/2020,$2.74,$0.00,$2622.58,Print
5/11/2020,$3.93,$0.00,$2625.32,Print
5/11/2020,$2.76,$0.00,$2629.25,Print
5/11/2020,$3.93,$0.00,$2632.01,Print
5/11/2020,$2.78,$0.00,$2635.94,Print
5/11/2020,$2.78,$0.00,$2638.72,Print
5/11/2020,$2.78,$0.00,$2641.50,Print
5/11/2020,$3.21,$0.00,$2644.28,Print
5/11/2020,$3.25,$0.00,$2647.49,Print
5/11/2020,$3.25,$0.00,$2650.74,Print
5/11/2020,$3.21,$0.00,$2653.99,Print
5/11/2020,$2.84,$0.00,$2657.20,Print
5/11/2020,$2.78,$0.00,$2660.04,Print
5/11/2020,$3.31,$0.00,$2662.82,Print
5/11/2020,$2.84,$0.00,$2666.13,Print
5/11/2020,$3.31,$0.00,$2668.97,Print
5/11/2020,$2.84,$0.00,$2672.28,Print
5/11/2020,$3.39,$0.00,$2675.12,Print
5/11/2020,$2.84,$0.00,$2678.51,Print
5/11/2020,$2.84,$0.00,$2681.35,Print
5/11/2020,$2.93,$0.00,$2684.19,Print
5/11/2020,$2.84,$0.00,$2687.12,Print
5/11/2020,$2.76,$0.00,$2689.96,Print
5/11/2020,$2.78,$0.00,$2692.72,Print
5/11/2020,$2.78,$0.00,$2695.50,Print
5/11/2020,$2.76,$0.00,$2698.28,Print
5/11/2020,$2.74,$0.00,$2701.04,Print
5/11/2020,$3.25,$0.00,$2703.78,Print
5/11/2020,$8.76,$0.00,$2707.03,Print
5/11/2020,$3.31,$0.00,$2715.79,Print
5/11/2020,$3.31,$0.00,$2719.10,Print
5/11/2020,$2.93,$0.00,$2722.41,Print
5/11/2020,$2.84,$0.00,$2725.34,Print
5/11/2020,$3.31,$0.00,$2728.18,Print
5/11/2020,$2.84,$0.00,$2731.49,Print
5/11/2020,$3.31,$0.00,$2734.33,Print
5/11/2020,$2.78,$0.00,$2737.64,Print
5/11/2020,$2.84,$0.00,$2740.42,Print
5/11/2020,$3.21,$0.00,$2743.26,Print
5/11/2020,$2.74,$0.00,$2746.47,Print
5/11/2020,$2.74,$0.00,$2749.21,Print
5/11/2020,$2.76,$0.00,$2751.95,Print
5/11/2020,$3.25,$0.00,$2754.71,Print
5/11/2020,$2.78,$0.00,$2757.96,Print
5/11/2020,$2.84,$0.00,$2760.74,Print
5/11/2020,$2.74,$0.00,$2763.58,Print
5/11/2020,$2.76,$0.00,$2766.32,Print
5/11/2020,$2.74,$0.00,$2769.08,Print
5/11/2020,$3.25,$0.00,$2771.82,Print
5/11/2020,$3.31,$0.00,$2775.07,Print
5/11/2020,$2.78,$0.00,$2778.38,Print
5/11/2020,$2.74,$0.00,$2781.16,Print
5/11/2020,$2.76,$0.00,$2783.90,Print
5/11/2020,$2.74,$0.00,$2786.66,Print
5/11/2020,$2.84,$0.00,$2789.40,Print
5/11/2020,$2.78,$0.00,$2792.24,Print
5/11/2020,$3.25,$0.00,$2795.02,Print
5/11/2020,$2.78,$0.00,$2798.27,Print
5/11/2020,$2.78,$0.00,$2801.05,Print
5/11/2020,$3.31,$0.00,$2803.83,Print
5/11/2020,$2.78,$0.00,$2807.14,Print
5/11/2020,$2.78,$0.00,$2809.92,Print
5/11/2020,$3.25,$0.00,$2812.70,Print
5/11/2020,$2.78,$0.00,$2815.95,Print
5/11/2020,$3.25,$0.00,$2818.73,Print
5/11/2020,$3.25,$0.00,$2821.98,Print
5/11/2020,$3.21,$0.00,$2825.23,Print
5/11/2020,$2.76,$0.00,$2828.44,Print
5/11/2020,$2.74,$0.00,$2831.20,Print
5/11/2020,$2.74,$0.00,$2833.94,Print
5/11/2020,$2.84,$0.00,$2836.68,Print
5/11/2020,$3.25,$0.00,$2839.52,Print
5/11/2020,$3.97,$0.00,$2842.77,Print
5/11/2020,$3.31,$0.00,$2846.74,Print
5/11/2020,$3.21,$0.00,$2850.05,Print
5/11/2020,$2.74,$0.00,$2853.26,Print
5/11/2020,$2.76,$0.00,$2856.00,Print
5/11/2020,$2.76,$0.00,$2858.76,Print
5/11/2020,$2.93,$0.00,$2861.52,Print
5/11/2020,$2.84,$0.00,$2864.45,Print
5/11/2020,$3.25,$0.00,$2867.29,Print
5/11/2020,$2.76,$0.00,$2870.54,Print
5/11/2020,$2.78,$0.00,$2873.30,Print
5/11/2020,$2.78,$0.00,$2876.08,Print
5/11/2020,$2.74,$0.00,$2878.86,Print
5/11/2020,$3.97,$0.00,$2881.60,Print
5/11/2020,$2.74,$0.00,$2885.57,Print
5/11/2020,$2.78,$0.00,$2888.31,Print
5/11/2020,$2.76,$0.00,$2891.09,Print
5/11/2020,$2.74,$0.00,$2893.85,Print
5/11/2020,$2.93,$0.00,$2896.59,Print
5/11/2020,$2.74,$0.00,$2899.52,Print
5/11/2020,$2.74,$0.00,$2902.26,Print
5/11/2020,$2.78,$0.00,$2905.00,Print
5/11/2020,$2.78,$0.00,$2907.78,Print
5/11/2020,$2.78,$0.00,$2910.56,Print
5/11/2020,$3.21,$0.00,$2913.34,Print
5/11/2020,$2.76,$0.00,$2916.55,Print
5/11/2020,$3.25,$0.00,$2919.31,Print
5/11/2020,$3.31,$0.00,$2922.56,Print
5/11/2020,$2.74,$0.00,$2925.87,Print
5/11/2020,$2.76,$0.00,$2928.61,Print
5/11/2020,$2.84,$0.00,$2931.37,Print
5/11/2020,$2.78,$0.00,$2934.21,Print
5/11/2020,$2.78,$0.00,$2936.99,Print
5/11/2020,$3.23,$0.00,$2939.77,Print
5/11/2020,$2.78,$0.00,$2943.00,Print
5/11/2020,$2.76,$0.00,$2945.78,Print
5/11/2020,$2.78,$0.00,$2948.54,Print
5/11/2020,$2.78,$0.00,$2951.32,Print
5/11/2020,$2.93,$0.00,$2954.10,Print
5/11/2020,$3.21,$0.00,$2957.03,Print
5/11/2020,$2.84,$0.00,$2960.24,Print
5/11/2020,$2.78,$0.00,$2963.08,Print
5/11/2020,$2.84,$0.00,$2965.86,Print
5/11/2020,$2.84,$0.00,$2968.70,Print
5/11/2020,$3.25,$0.00,$2971.54,Print
5/11/2020,$2.74,$0.00,$2974.79,Print
5/11/2020,$2.84,$0.00,$2977.53,Print
5/11/2020,$2.84,$0.00,$2980.37,Print
5/11/2020,$3.21,$0.00,$2983.21,Print
5/11/2020,$2.74,$0.00,$2986.42,Print
5/11/2020,$2.76,$0.00,$2989.16,Print
5/11/2020,$2.74,$0.00,$2991.92,Print
5/11/2020,$2.76,$0.00,$2994.66,Print
5/11/2020,$3.25,$0.00,$2997.42,Print
5/11/2020,$2.84,$0.00,$3000.67,Print
5/11/2020,$2.76,$0.00,$3003.51,Print
5/11/2020,$3.21,$0.00,$3006.27,Print
5/11/2020,$3.23,$0.00,$3009.48,Print
5/11/2020,$2.76,$0.00,$3012.71,Print
5/11/2020,$2.74,$0.00,$3015.47,Print
5/11/2020,$3.31,$0.00,$3018.21,Print
5/11/2020,$2.74,$0.00,$3021.52,Print
5/11/2020,$2.84,$0.00,$3024.26,Print
5/11/2020,$2.76,$0.00,$3027.10,Print
5/11/2020,$2.84,$0.00,$3029.86,Print
5/11/2020,$2.74,$0.00,$3032.70,Print
5/11/2020,$2.78,$0.00,$3035.44,Print
5/11/2020,$2.76,$0.00,$3038.22,Print
5/11/2020,$2.78,$0.00,$3040.98,Print
5/11/2020,$14.39,$0.00,$3043.76,Print
5/11/2020,$2.78,$0.00,$3058.15,Print
5/11/2020,$2.74,$0.00,$3060.93,Print
5/11/2020,$2.74,$0.00,$3063.67,Print
5/11/2020,$2.93,$0.00,$3066.41,Print
5/11/2020,$2.84,$0.00,$3069.34,Print
5/11/2020,$2.84,$0.00,$3072.18,Print
5/11/2020,$3.31,$0.00,$3075.02,Print
5/11/2020,$3.25,$0.00,$3078.33,Print
5/11/2020,$2.74,$0.00,$3081.58,Print
5/11/2020,$3.25,$0.00,$3084.32,Print
5/11/2020,$2.84,$0.00,$3087.57,Print
5/11/2020,$2.78,$0.00,$3090.41,Print
5/11/2020,$3.31,$0.00,$3093.19,Print
5/11/2020,$2.84,$0.00,$3096.50,Print
5/11/2020,$3.31,$0.00,$3099.34,Print
5/11/2020,$2.84,$0.00,$3102.65,Print
5/11/2020,$2.84,$0.00,$3105.49,Print
5/11/2020,$3.52,$0.00,$3108.33,Print
5/11/2020,$2.84,$0.00,$3111.85,Print
5/11/2020,$3.31,$0.00,$3114.69,Print
5/11/2020,$2.78,$0.00,$3118.00,Print
5/11/2020,$2.78,$0.00,$3120.78,Print
5/11/2020,$2.74,$0.00,$3123.56,Print
5/11/2020,$2.74,$0.00,$3126.30,Print
5/11/2020,$2.78,$0.00,$3129.04,Print
5/11/2020,$2.76,$0.00,$3131.82,Print
5/11/2020,$3.25,$0.00,$3134.58,Print
5/11/2020,$3.31,$0.00,$3137.83,Print
5/11/2020,$2.78,$0.00,$3141.14,Print
5/11/2020,$3.25,$0.00,$3143.92,Print
5/11/2020,$3.31,$0.00,$3147.17,Print
5/11/2020,$3.31,$0.00,$3150.48,Print
5/11/2020,$3.25,$0.00,$3153.79,Print
5/11/2020,$2.74,$0.00,$3157.04,Print
5/11/2020,$7.02,$0.00,$3159.78,Print
5/11/2020,$2.84,$0.00,$3166.80,Print
5/11/2020,$2.84,$0.00,$3169.64,Print
5/11/2020,$2.84,$0.00,$3172.48,Print
5/11/2020,$2.78,$0.00,$3175.32,Print
5/11/2020,$2.84,$0.00,$3178.10,Print
5/11/2020,$2.84,$0.00,$3180.94,Print
5/11/2020,$2.84,$0.00,$3183.78,Print
5/11/2020,$5.27,$0.00,$3186.62,Print
5/11/2020,$2.84,$0.00,$3191.89,Print
5/11/2020,$4.18,$0.00,$3194.73,Print
5/11/2020,$2.78,$0.00,$3198.91,Print
5/11/2020,$3.31,$0.00,$3201.69,Print
5/11/2020,$2.76,$0.00,$3205.00,Print
5/11/2020,$2.78,$0.00,$3207.76,Print
5/11/2020,$2.78,$0.00,$3210.54,Print
5/11/2020,$2.76,$0.00,$3213.32,Print
5/11/2020,$3.21,$0.00,$3216.08,Print
5/11/2020,$2.76,$0.00,$3219.29,Print
5/11/2020,$2.84,$0.00,$3222.05,Print
5/11/2020,$2.78,$0.00,$3224.89,Print
5/11/2020,$2.78,$0.00,$3227.67,Print
5/11/2020,$2.84,$0.00,$3230.45,Print
5/11/2020,$2.78,$0.00,$3233.29,Print
5/11/2020,$2.74,$0.00,$3236.07,Print
5/11/2020,$2.78,$0.00,$3238.81,Print
5/11/2020,$2.84,$0.00,$3241.59,Print
5/11/2020,$3.23,$0.00,$3244.43,Print
5/11/2020,$2.84,$0.00,$3247.66,Print
5/11/2020,$3.52,$0.00,$3250.50,Print
5/11/2020,$5.04,$0.00,$3254.02,Print
5/11/2020,$4.00,$0.00,$3259.06,Print
5/11/2020,$4.08,$0.00,$3263.06,Print
5/11/2020,$2.84,$0.00,$3267.14,Print
5/11/2020,$4.08,$0.00,$3269.98,Print
5/11/2020,$2.84,$0.00,$3274.06,Print
5/11/2020,$2.74,$0.00,$3276.90,Print
5/11/2020,$3.21,$0.00,$3279.64,Print
5/11/2020,$2.78,$0.00,$3282.85,Print
5/11/2020,$2.78,$0.00,$3285.63,Print
5/11/2020,$2.74,$0.00,$3288.41,Print
5/11/2020,$3.97,$0.00,$3291.15,Print
5/11/2020,$3.25,$0.00,$3295.12,Print
5/11/2020,$3.23,$0.00,$3298.37,Print
5/11/2020,$3.31,$0.00,$3301.60,Print
5/11/2020,$3.97,$0.00,$3304.91,Print
5/11/2020,$4.00,$0.00,$3308.88,Print
5/11/2020,$3.31,$0.00,$3312.88,Print
5/11/2020,$3.31,$0.00,$3316.19,Print
5/11/2020,$3.93,$0.00,$3319.50,Print
5/11/2020,$5.04,$0.00,$3323.43,Print
5/11/2020,$3.25,$0.00,$3328.47,Print
5/11/2020,$3.23,$0.00,$3331.72,Print
5/11/2020,$5.27,$0.00,$3334.95,Print
5/11/2020,$2.74,$0.00,$3340.22,Print
5/11/2020,$2.78,$0.00,$3342.96,Print
5/11/2020,$2.84,$0.00,$3345.74,Print
5/11/2020,$3.25,$0.00,$3348.58,Print
5/11/2020,$2.84,$0.00,$3351.83,Print
5/11/2020,$3.23,$0.00,$3354.67,Print
5/11/2020,$3.25,$0.00,$3357.90,Print
5/11/2020,$2.76,$0.00,$3361.15,Print
5/11/2020,$3.25,$0.00,$3363.91,Print
5/11/2020,$4.08,$0.00,$3367.16,Print
5/11/2020,$3.25,$0.00,$3371.24,Print
5/11/2020,$3.25,$0.00,$3374.49,Print
5/11/2020,$2.78,$0.00,$3377.74,Print
5/11/2020,$2.76,$0.00,$3380.52,Print
5/11/2020,$2.84,$0.00,$3383.28,Print
5/11/2020,$3.05,$0.00,$3386.12,Print
5/11/2020,$2.74,$0.00,$3389.17,Print
5/11/2020,$2.78,$0.00,$3391.91,Print
5/11/2020,$3.25,$0.00,$3394.69,Print
5/11/2020,$2.84,$0.00,$3397.94,Print
5/11/2020,$2.78,$0.00,$3400.78,Print
5/11/2020,$3.31,$0.00,$3403.56,Print
5/11/2020,$3.23,$0.00,$3406.87,Print
5/11/2020,$3.31,$0.00,$3410.10,Print
5/11/2020,$2.84,$0.00,$3413.41,Print
5/11/2020,$4.08,$0.00,$3416.25,Print
5/11/2020,$2.78,$0.00,$3420.33,Print
5/11/2020,$2.76,$0.00,$3423.11,Print
5/11/2020,$3.21,$0.00,$3425.87,Print
5/11/2020,$3.39,$0.00,$3429.08,Print
5/11/2020,$2.84,$0.00,$3432.47,Print
5/11/2020,$2.84,$0.00,$3435.31,Print
5/11/2020,$2.76,$0.00,$3438.15,Print
5/11/2020,$2.84,$0.00,$3440.91,Print
5/11/2020,$2.84,$0.00,$3443.75,Print
5/11/2020,$2.84,$0.00,$3446.59,Print
5/11/2020,$2.84,$0.00,$3449.43,Print
5/11/2020,$2.78,$0.00,$3452.27,Print
5/11/2020,$2.78,$0.00,$3455.05,Print
5/11/2020,$3.39,$0.00,$3457.83,Print
5/11/2020,$2.84,$0.00,$3461.22,Print
5/11/2020,$2.78,$0.00,$3464.06,Print
5/11/2020,$2.84,$0.00,$3466.84,Print
5/11/2020,$2.78,$0.00,$3469.68,Print
5/11/2020,$2.74,$0.00,$3472.46,Print
5/11/2020,$3.31,$0.00,$3475.20,Print
5/11/2020,$2.93,$0.00,$3478.51,Print
5/11/2020,$2.78,$0.00,$3481.44,Print
5/11/2020,$2.76,$0.00,$3484.22,Print
5/11/2020,$2.84,$0.00,$3486.98,Print
5/11/2020,$2.76,$0.00,$3489.82,Print
5/11/2020,$2.76,$0.00,$3492.58,Print
5/11/2020,$2.84,$0.00,$3495.34,Print
5/11/2020,$2.76,$0.00,$3498.18,Print
5/11/2020,$2.78,$0.00,$3500.94,Print
5/11/2020,$2.78,$0.00,$3503.72,Print
5/11/2020,$3.23,$0.00,$3506.50,Print
5/11/2020,$5.04,$0.00,$3509.73,Print
5/11/2020,$2.76,$0.00,$3514.77,Print
5/11/2020,$2.78,$0.00,$3517.53,Print
5/11/2020,$2.84,$0.00,$3520.31,Print
5/11/2020,$3.21,$0.00,$3523.15,Print
5/11/2020,$3.21,$0.00,$3526.36,Print
5/11/2020,$2.84,$0.00,$3529.57,Print
5/11/2020,$3.25,$0.00,$3532.41,Print
5/11/2020,$5.08,$0.00,$3535.66,Print
5/11/2020,$2.78,$0.00,$3540.74,Print
5/11/2020,$2.74,$0.00,$3543.52,Print
5/11/2020,$2.84,$0.00,$3546.26,Print
5/11/2020,$2.84,$0.00,$3549.10,Print
5/11/2020,$2.93,$0.00,$3551.94,Print
5/11/2020,$2.84,$0.00,$3554.87,Print
5/11/2020,$2.78,$0.00,$3557.71,Print
5/11/2020,$2.74,$0.00,$3560.49,Print
5/11/2020,$2.76,$0.00,$3563.23,Print
5/11/2020,$2.84,$0.00,$3565.99,Print
5/11/2020,$3.97,$0.00,$3568.83,Print
5/11/2020,$2.84,$0.00,$3572.80,Print
5/11/2020,$2.78,$0.00,$3575.64,Print
5/11/2020,$3.31,$0.00,$3578.42,Print
5/11/2020,$3.31,$0.00,$3581.73,Print
5/11/2020,$2.78,$0.00,$3585.04,Print
5/11/2020,$3.23,$0.00,$3587.82,Print
5/11/2020,$3.52,$0.00,$3591.05,Print
5/11/2020,$2.84,$0.00,$3594.57,Print
5/11/2020,$2.76,$0.00,$3597.41,Print
5/11/2020,$3.23,$0.00,$3600.17,Print
5/11/2020,$2.78,$0.00,$3603.40,Print
5/11/2020,$2.74,$0.00,$3606.18,Print
5/11/2020,$4.00,$0.00,$3608.92,Print
5/11/2020,$2.84,$0.00,$3612.92,Print
5/11/2020,$4.00,$0.00,$3615.76,Print
5/11/2020,$2.76,$0.00,$3619.76,Print
5/11/2020,$2.74,$0.00,$3622.52,Print
5/11/2020,$5.04,$0.00,$3625.26,Print
5/11/2020,$3.31,$0.00,$3630.30,Print
5/11/2020,$2.84,$0.00,$3633.61,Print
5/11/2020,$3.25,$0.00,$3636.45,Print
5/11/2020,$2.78,$0.00,$3639.70,Print
5/11/2020,$3.21,$0.00,$3642.48,Print
5/11/2020,$3.31,$0.00,$3645.69,Print
5/11/2020,$3.23,$0.00,$3649.00,Print
5/11/2020,$2.78,$0.00,$3652.23,Print
5/11/2020,$3.21,$0.00,$3655.01,Print
5/11/2020,$2.84,$0.00,$3658.22,Print
5/11/2020,$3.23,$0.00,$3661.06,Print
5/11/2020,$2.76,$0.00,$3664.29,Print
5/11/2020,$2.84,$0.00,$3667.05,Print
5/11/2020,$2.84,$0.00,$3669.89,Print
5/11/2020,$2.84,$0.00,$3672.73,Print
5/11/2020,$3.25,$0.00,$3675.57,Print
5/11/2020,$2.84,$0.00,$3678.82,Print
5/11/2020,$2.78,$0.00,$3681.66,Print
5/11/2020,$2.74,$0.00,$3684.44,Print
5/11/2020,$3.23,$0.00,$3687.18,Print
5/11/2020,$2.84,$0.00,$3690.41,Print
5/11/2020,$3.39,$0.00,$3693.25,Print
5/11/2020,$2.84,$0.00,$3696.64,Print
5/11/2020,$2.84,$0.00,$3699.48,Print
5/11/2020,$3.31,$0.00,$3702.32,Print
5/11/2020,$3.21,$0.00,$3705.63,Print
5/11/2020,$3.25,$0.00,$3708.84,Print
5/11/2020,$3.31,$0.00,$3712.09,Print
5/11/2020,$3.21,$0.00,$3715.40,Print
5/11/2020,$3.31,$0.00,$3718.61,Print
5/11/2020,$3.39,$0.00,$3721.92,Print
5/11/2020,$3.31,$0.00,$3725.31,Print
5/11/2020,$2.84,$0.00,$3728.62,Print
5/11/2020,$3.25,$0.00,$3731.46,Print
5/11/2020,$2.78,$0.00,$3734.71,Print
5/11/2020,$3.25,$0.00,$3737.49,Print
5/11/2020,$3.25,$0.00,$3740.74,Print
5/11/2020,$3.31,$0.00,$3743.99,Print
5/11/2020,$3.31,$0.00,$3747.30,Print
5/11/2020,$2.93,$0.00,$3750.61,Print
5/11/2020,$2.84,$0.00,$3753.54,Print
5/11/2020,$2.84,$0.00,$3756.38,Print
5/11/2020,$2.84,$0.00,$3759.22,Print
5/11/2020,$2.78,$0.00,$3762.06,Print
5/11/2020,$2.78,$0.00,$3764.84,Print
5/11/2020,$3.25,$0.00,$3767.62,Print
5/11/2020,$2.84,$0.00,$3770.87,Print
5/11/2020,$2.84,$0.00,$3773.71,Print
5/11/2020,$2.84,$0.00,$3776.55,Print
5/11/2020,$3.31,$0.00,$3779.39,Print
5/11/2020,$2.78,$0.00,$3782.70,Print
5/11/2020,$2.84,$0.00,$3785.48,Print
5/11/2020,$3.05,$0.00,$3788.32,Print
5/11/2020,$3.21,$0.00,$3791.37,Print
5/11/2020,$2.84,$0.00,$3794.58,Print
5/11/2020,$2.84,$0.00,$3797.42,Print
5/11/2020,$2.74,$0.00,$3800.26,Print
5/11/2020,$2.76,$0.00,$3803.00,Print
5/11/2020,$2.74,$0.00,$3805.76,Print
5/11/2020,$3.25,$0.00,$3808.50,Print
5/11/2020,$3.31,$0.00,$3811.75,Print
5/11/2020,$3.39,$0.00,$3815.06,Print
5/11/2020,$2.78,$0.00,$3818.45,Print
5/11/2020,$2.74,$0.00,$3821.23,Print
5/11/2020,$2.74,$0.00,$3823.97,Print
5/11/2020,$2.74,$0.00,$3826.71,Print
5/11/2020,$3.31,$0.00,$3829.45,Print
5/11/2020,$2.74,$0.00,$3832.76,Print
5/11/2020,$2.78,$0.00,$3835.50,Print
5/11/2020,$2.78,$0.00,$3838.28,Print
5/11/2020,$3.31,$0.00,$3841.06,Print
5/11/2020,$2.84,$0.00,$3844.37,Print
5/11/2020,$2.84,$0.00,$3847.21,Print
5/11/2020,$3.25,$0.00,$3850.05,Print
5/11/2020,$2.84,$0.00,$3853.30,Print
5/11/2020,$2.76,$0.00,$3856.14,Print
5/11/2020,$2.74,$0.00,$3858.90,Print
5/11/2020,$2.84,$0.00,$3861.64,Print
5/11/2020,$5.08,$0.00,$3864.48,Print
5/11/2020,$3.23,$0.00,$3869.56,Print
5/11/2020,$3.25,$0.00,$3872.79,Print
5/11/2020,$3.67,$0.00,$3876.04,Print
5/11/2020,$2.76,$0.00,$3879.71,Print
5/11/2020,$2.84,$0.00,$3882.47,Print
5/11/2020,$2.78,$0.00,$3885.31,Print
5/11/2020,$3.31,$0.00,$3888.09,Print
5/11/2020,$2.76,$0.00,$3891.40,Print
5/11/2020,$2.74,$0.00,$3894.16,Print
5/11/2020,$3.31,$0.00,$3896.90,Print
5/11/2020,$3.25,$0.00,$3900.21,Print
5/11/2020,$3.23,$0.00,$3903.46,Print
5/11/2020,$2.78,$0.00,$3906.69,Print
5/11/2020,$3.23,$0.00,$3909.47,Print
5/11/2020,$3.21,$0.00,$3912.70,Print
5/11/2020,$3.21,$0.00,$3915.91,Print
5/11/2020,$2.84,$0.00,$3919.12,Print
5/11/2020,$2.78,$0.00,$3921.96,Print
5/11/2020,$3.21,$0.00,$3924.74,Print
5/11/2020,$3.25,$0.00,$3927.95,Print
5/11/2020,$2.78,$0.00,$3931.20,Print
5/11/2020,$3.21,$0.00,$3933.98,Print
5/11/2020,$2.78,$0.00,$3937.19,Print
5/11/2020,$2.78,$0.00,$3939.97,Print
5/11/2020,$2.78,$0.00,$3942.75,Print
5/11/2020,$3.25,$0.00,$3945.53,Print
5/11/2020,$2.84,$0.00,$3948.78,Print
5/11/2020,$5.04,$0.00,$3951.62,Print
5/11/2020,$3.23,$0.00,$3956.66,Print
5/11/2020,$3.39,$0.00,$3959.89,Print
5/11/2020,$3.39,$0.00,$3963.28,Print
5/11/2020,$3.39,$0.00,$3966.67,Print
5/11/2020,$3.25,$0.00,$3970.06,Print
5/11/2020,$3.23,$0.00,$3973.31,Print
5/11/2020,$3.23,$0.00,$3976.54,Print
5/11/2020,$3.23,$0.00,$3979.77,Print
5/11/2020,$3.25,$0.00,$3983.00,Print
5/11/2020,$3.21,$0.00,$3986.25,Print
5/11/2020,$2.76,$0.00,$3989.46,Print
5/11/2020,$2.84,$0.00,$3992.22,Print
5/11/2020,$3.21,$0.00,$3995.06,Print
5/11/2020,$2.78,$0.00,$3998.27,Print
5/11/2020,$2.84,$0.00,$4001.05,Print
5/11/2020,$2.78,$0.00,$4003.89,Print
5/11/2020,$2.74,$0.00,$4006.67,Print
5/11/2020,$2.84,$0.00,$4009.41,Print
5/11/2020,$2.84,$0.00,$4012.25,Print
5/11/2020,$2.74,$0.00,$4015.09,Print
5/11/2020,$2.76,$0.00,$4017.83,Print
5/11/2020,$2.76,$0.00,$4020.59,Print
5/11/2020,$2.76,$0.00,$4023.35,Print
5/11/2020,$2.78,$0.00,$4026.11,Print
5/11/2020,$2.74,$0.00,$4028.89,Print
5/11/2020,$2.74,$0.00,$4031.63,Print
5/11/2020,$2.76,$0.00,$4034.37,Print
5/11/2020,$2.74,$0.00,$4037.13,Print
5/11/2020,$2.84,$0.00,$4039.87,Print
5/11/2020,$2.84,$0.00,$4042.71,Print
5/11/2020,$2.84,$0.00,$4045.55,Print
5/11/2020,$2.84,$0.00,$4048.39,Print
5/11/2020,$2.84,$0.00,$4051.23,Print
5/11/2020,$2.74,$0.00,$4054.07,Print
5/11/2020,$2.78,$0.00,$4056.81,Print
5/11/2020,$2.76,$0.00,$4059.59,Print
5/11/2020,$2.76,$0.00,$4062.35,Print
5/11/2020,$2.84,$0.00,$4065.11,Print
5/11/2020,$2.84,$0.00,$4067.95,Print
5/11/2020,$2.78,$0.00,$4070.79,Print
5/11/2020,$2.76,$0.00,$4073.57,Print
5/11/2020,$2.84,$0.00,$4076.33,Print
5/11/2020,$2.78,$0.00,$4079.17,Print
5/11/2020,$2.76,$0.00,$4081.95,Print
5/11/2020,$4.00,$0.00,$4084.71,Print
5/11/2020,$2.78,$0.00,$4088.71,Print
5/11/2020,$2.78,$0.00,$4091.49,Print
5/11/2020,$2.74,$0.00,$4094.27,Print
5/11/2020,$2.78,$0.00,$4097.01,Print
5/11/2020,$2.74,$0.00,$4099.79,Print
5/11/2020,$2.84,$0.00,$4102.53,Print
5/11/2020,$2.74,$0.00,$4105.37,Print
5/11/2020,$5.12,$0.00,$4108.11,Print
5/11/2020,$2.76,$0.00,$4113.23,Print
5/11/2020,$2.84,$0.00,$4115.99,Print
5/11/2020,$2.84,$0.00,$4118.83,Print
5/11/2020,$2.84,$0.00,$4121.67,Print
5/11/2020,$3.31,$0.00,$4124.51,Print
5/11/2020,$2.84,$0.00,$4127.82,Print
5/11/2020,$2.76,$0.00,$4130.66,Print
5/11/2020,$2.84,$0.00,$4133.42,Print
5/11/2020,$2.84,$0.00,$4136.26,Print
5/11/2020,$2.84,$0.00,$4139.10,Print
5/11/2020,$2.76,$0.00,$4141.94,Print
5/10/2020,$2.84,$0.00,$4144.70,Print
5/10/2020,$2.74,$0.00,$4147.54,Print
5/10/2020,$2.76,$0.00,$4150.28,Print
5/10/2020,$3.25,$0.00,$4153.04,Print
5/10/2020,$3.21,$0.00,$4156.29,Print
5/10/2020,$2.78,$0.00,$4159.50,Print
5/10/2020,$2.84,$0.00,$4162.28,Print
5/10/2020,$2.84,$0.00,$4165.12,Print
5/10/2020,$2.78,$0.00,$4167.96,Print
5/10/2020,$3.93,$0.00,$4170.74,Print
5/10/2020,$2.84,$0.00,$4174.67,Print
5/10/2020,$2.84,$0.00,$4177.51,Print
5/10/2020,$2.84,$0.00,$4180.35,Print
5/10/2020,$2.78,$0.00,$4183.19,Print
5/10/2020,$2.78,$0.00,$4185.97,Print
5/10/2020,$2.78,$0.00,$4188.75,Print
5/10/2020,$2.84,$0.00,$4191.53,Print
5/10/2020,$2.84,$0.00,$4194.37,Print
5/10/2020,$3.21,$0.00,$4197.21,Print
5/10/2020,$2.84,$0.00,$4200.42,Print
5/10/2020,$3.31,$0.00,$4203.26,Print
5/10/2020,$2.76,$0.00,$4206.57,Print
5/10/2020,$5.12,$0.00,$4209.33,Print
5/10/2020,$5.40,$0.00,$4214.45,Print
5/10/2020,$2.74,$0.00,$4219.85,Print
5/10/2020,$2.84,$0.00,$4222.59,Print
5/10/2020,$3.25,$0.00,$4225.43,Print
5/10/2020,$4.00,$0.00,$4228.68,Print
5/10/2020,$2.84,$0.00,$4232.68,Print
5/10/2020,$3.93,$0.00,$4235.52,Print
5/10/2020,$3.23,$0.00,$4239.45,Print
5/10/2020,$2.76,$0.00,$4242.68,Print
5/10/2020,$2.84,$0.00,$4245.44,Print
5/10/2020,$2.84,$0.00,$4248.28,Print
5/10/2020,$2.76,$0.00,$4251.12,Print
5/10/2020,$2.84,$0.00,$4253.88,Print
5/10/2020,$2.84,$0.00,$4256.72,Print
5/10/2020,$2.74,$0.00,$4259.56,Print
5/10/2020,$3.25,$0.00,$4262.30,Print
5/10/2020,$2.84,$0.00,$4265.55,Print
5/10/2020,$3.31,$0.00,$4268.39,Print
5/10/2020,$2.76,$0.00,$4271.70,Print
5/10/2020,$2.76,$0.00,$4274.46,Print
5/10/2020,$2.76,$0.00,$4277.22,Print
5/10/2020,$2.76,$0.00,$4279.98,Print
5/10/2020,$2.74,$0.00,$4282.74,Print
5/10/2020,$2.74,$0.00,$4285.48,Print
5/10/2020,$3.21,$0.00,$4288.22,Print
5/10/2020,$2.84,$0.00,$4291.43,Print
5/10/2020,$3.25,$0.00,$4294.27,Print
5/10/2020,$3.23,$0.00,$4297.52,Print
5/10/2020,$2.78,$0.00,$4300.75,Print
5/10/2020,$2.76,$0.00,$4303.53,Print
5/10/2020,$2.76,$0.00,$4306.29,Print
5/10/2020,$2.84,$0.00,$4309.05,Print
5/10/2020,$2.76,$0.00,$4311.89,Print
5/10/2020,$2.84,$0.00,$4314.65,Print
5/10/2020,$2.84,$0.00,$4317.49,Print
5/10/2020,$2.84,$0.00,$4320.33,Print
5/10/2020,$3.31,$0.00,$4323.17,Print
5/10/2020,$2.84,$0.00,$4326.48,Print
5/10/2020,$2.84,$0.00,$4329.32,Print
5/10/2020,$2.76,$0.00,$4332.16,Print
5/10/2020,$2.78,$0.00,$4334.92,Print
5/10/2020,$2.76,$0.00,$4337.70,Print
5/10/2020,$2.74,$0.00,$4340.46,Print
5/10/2020,$3.21,$0.00,$4343.20,Print
5/10/2020,$2.76,$0.00,$4346.41,Print
5/10/2020,$2.76,$0.00,$4349.17,Print
5/10/2020,$2.78,$0.00,$4351.93,Print
5/10/2020,$2.78,$0.00,$4354.71,Print
5/10/2020,$3.93,$0.00,$4357.49,Print
5/10/2020,$5.12,$0.00,$4361.42,Print
5/10/2020,$3.25,$0.00,$4366.54,Print
5/10/2020,$2.76,$0.00,$4369.79,Print
5/10/2020,$2.74,$0.00,$4372.55,Print
5/10/2020,$3.21,$0.00,$4375.29,Print
5/10/2020,$3.25,$0.00,$4378.50,Print
5/10/2020,$7.84,$0.00,$4381.75,Print
5/10/2020,$4.08,$0.00,$4389.59,Print
5/10/2020,$2.74,$0.00,$4393.67,Print
5/10/2020,$2.74,$0.00,$4396.41,Print
5/10/2020,$3.23,$0.00,$4399.15,Print
5/10/2020,$3.21,$0.00,$4402.38,Print
5/10/2020,$5.27,$0.00,$4405.59,Print
5/10/2020,$3.25,$0.00,$4410.86,Print
5/10/2020,$5.27,$0.00,$4414.11,Print
5/10/2020,$3.25,$0.00,$4419.38,Print
5/10/2020,$3.31,$0.00,$4422.63,Print
5/10/2020,$3.31,$0.00,$4425.94,Print
5/10/2020,$3.21,$0.00,$4429.25,Print
5/10/2020,$5.27,$0.00,$4432.46,Print
5/10/2020,$3.23,$0.00,$4437.73,Print
5/10/2020,$3.23,$0.00,$4440.96,Print
5/10/2020,$3.25,$0.00,$4444.19,Print
5/10/2020,$3.31,$0.00,$4447.44,Print
5/10/2020,$3.21,$0.00,$4450.75,Print
5/10/2020,$3.21,$0.00,$4453.96,Print
5/10/2020,$3.23,$0.00,$4457.17,Print
5/10/2020,$3.31,$0.00,$4460.40,Print
5/10/2020,$3.21,$0.00,$4463.71,Print
5/10/2020,$3.25,$0.00,$4466.92,Print
5/10/2020,$2.84,$0.00,$4470.17,Print
5/10/2020,$3.23,$0.00,$4473.01,Print
5/10/2020,$3.25,$0.00,$4476.24,Print
5/10/2020,$2.84,$0.00,$4479.49,Print
5/10/2020,$2.78,$0.00,$4482.33,Print
5/10/2020,$3.23,$0.00,$4485.11,Print
5/10/2020,$3.97,$0.00,$4488.34,Print
5/10/2020,$4.00,$0.00,$4492.31,Print
5/10/2020,$2000.00,$0.00,$4496.31,Purchase
5/10/2020,$3.93,$0.00,$2496.31,Print
5/10/2020,$3.21,$0.00,$2500.24,Print
5/10/2020,$3.21,$0.00,$2503.45,Print
5/10/2020,$3.23,$0.00,$2506.66,Print
5/10/2020,$3.31,$0.00,$2509.89,Print
5/10/2020,$3.21,$0.00,$2513.20,Print
5/10/2020,$3.23,$0.00,$2516.41,Print
5/10/2020,$3.25,$0.00,$2519.64,Print
5/10/2020,$3.21,$0.00,$2522.89,Print
5/10/2020,$3.21,$0.00,$2526.10,Print
5/10/2020,$3.25,$0.00,$2529.31,Print
5/10/2020,$3.21,$0.00,$2532.56,Print
5/10/2020,$3.23,$0.00,$2535.77,Print
5/10/2020,$3.21,$0.00,$2539.00,Print
5/10/2020,$2.76,$0.00,$2542.21,Print
5/10/2020,$2.76,$0.00,$2544.97,Print
5/10/2020,$3.23,$0.00,$2547.73,Print
5/10/2020,$3.21,$0.00,$2550.96,Print
5/10/2020,$3.23,$0.00,$2554.17,Print
5/10/2020,$3.25,$0.00,$2557.40,Print
5/10/2020,$37.77,$0.00,$2560.65,Print
5/10/2020,$3.23,$0.00,$2598.42,Print
5/10/2020,$3.23,$0.00,$2601.65,Print
5/10/2020,$2.76,$0.00,$2604.88,Print
5/10/2020,$3.23,$0.00,$2607.64,Print
5/10/2020,$4.00,$0.00,$2610.87,Print
5/10/2020,$4.00,$0.00,$2614.87,Print
5/10/2020,$3.21,$0.00,$2618.87,Print
5/10/2020,$3.21,$0.00,$2622.08,Print
5/10/2020,$3.23,$0.00,$2625.29,Print
5/10/2020,$2.76,$0.00,$2628.52,Print
5/10/2020,$3.23,$0.00,$2631.28,Print
5/10/2020,$2.74,$0.00,$2634.51,Print
5/10/2020,$3.21,$0.00,$2637.25,Print
5/10/2020,$3.97,$0.00,$2640.46,Print
5/10/2020,$3.23,$0.00,$2644.43,Print
5/10/2020,$3.23,$0.00,$2647.66,Print
5/10/2020,$3.25,$0.00,$2650.89,Print
5/10/2020,$3.21,$0.00,$2654.14,Print
5/10/2020,$3.23,$0.00,$2657.35,Print
5/10/2020,$3.21,$0.00,$2660.58,Print
5/10/2020,$3.23,$0.00,$2663.79,Print
5/10/2020,$3.21,$0.00,$2667.02,Print
5/10/2020,$3.23,$0.00,$2670.23,Print
5/10/2020,$3.21,$0.00,$2673.46,Print
5/10/2020,$3.31,$0.00,$2676.67,Print
5/10/2020,$3.23,$0.00,$2679.98,Print
5/10/2020,$2.76,$0.00,$2683.21,Print
5/10/2020,$3.23,$0.00,$2685.97,Print
5/10/2020,$3.23,$0.00,$2689.20,Print
5/10/2020,$7.80,$0.00,$2692.43,Print
5/10/2020,$5.27,$0.00,$2700.23,Print
5/10/2020,$3.93,$0.00,$2705.50,Print
5/10/2020,$2.76,$0.00,$2709.43,Print
5/10/2020,$3.21,$0.00,$2712.19,Print
5/10/2020,$8.23,$0.00,$2715.40,Print
5/10/2020,$3.23,$0.00,$2723.63,Print
5/10/2020,$3.23,$0.00,$2726.86,Print
5/10/2020,$3.31,$0.00,$2730.09,Print
5/10/2020,$3.21,$0.00,$2733.40,Print
5/10/2020,$3.23,$0.00,$2736.61,Print
5/10/2020,$3.25,$0.00,$2739.84,Print
5/10/2020,$3.23,$0.00,$2743.09,Print
5/10/2020,$3.21,$0.00,$2746.32,Print
5/10/2020,$2.74,$0.00,$2749.53,Print
5/10/2020,$3.23,$0.00,$2752.27,Print
5/10/2020,$2.76,$0.00,$2755.50,Print
5/10/2020,$3.23,$0.00,$2758.26,Print
5/10/2020,$2.78,$0.00,$2761.49,Print
5/10/2020,$2.84,$0.00,$2764.27,Print
5/10/2020,$2.84,$0.00,$2767.11,Print
5/10/2020,$3.25,$0.00,$2769.95,Print
5/10/2020,$2.74,$0.00,$2773.20,Print
5/10/2020,$3.31,$0.00,$2775.94,Print
5/10/2020,$3.21,$0.00,$2779.25,Print
5/10/2020,$2.84,$0.00,$2782.46,Print
5/10/2020,$2.78,$0.00,$2785.30,Print
5/10/2020,$3.31,$0.00,$2788.08,Print
5/10/2020,$3.21,$0.00,$2791.39,Print
5/10/2020,$3.21,$0.00,$2794.60,Print
5/10/2020,$3.25,$0.00,$2797.81,Print
5/10/2020,$2.78,$0.00,$2801.06,Print
5/10/2020,$3.97,$0.00,$2803.84,Print
5/10/2020,$2.74,$0.00,$2807.81,Print
5/10/2020,$2.76,$0.00,$2810.55,Print
5/10/2020,$2.74,$0.00,$2813.31,Print
5/10/2020,$2.74,$0.00,$2816.05,Print
5/10/2020,$2.76,$0.00,$2818.79,Print
5/10/2020,$3.05,$0.00,$2821.55,Print
5/10/2020,$2.74,$0.00,$2824.60,Print
5/10/2020,$2.74,$0.00,$2827.34,Print
5/10/2020,$3.52,$0.00,$2830.08,Print
5/10/2020,$2.76,$0.00,$2833.60,Print
5/10/2020,$2.78,$0.00,$2836.36,Print
5/10/2020,$2.74,$0.00,$2839.14,Print
5/10/2020,$2.74,$0.00,$2841.88,Print
5/10/2020,$2.76,$0.00,$2844.62,Print
5/10/2020,$3.31,$0.00,$2847.38,Print
5/10/2020,$2.76,$0.00,$2850.69,Print
5/10/2020,$2.84,$0.00,$2853.45,Print
5/10/2020,$2.74,$0.00,$2856.29,Print
5/10/2020,$2.78,$0.00,$2859.03,Print
5/10/2020,$2.84,$0.00,$2861.81,Print
5/10/2020,$2.84,$0.00,$2864.65,Print
5/10/2020,$2.84,$0.00,$2867.49,Print
5/10/2020,$2.78,$0.00,$2870.33,Print
5/10/2020,$2.76,$0.00,$2873.11,Print
5/10/2020,$3.23,$0.00,$2875.87,Print
5/10/2020,$2.78,$0.00,$2879.10,Print
5/10/2020,$2.84,$0.00,$2881.88,Print
5/10/2020,$2.78,$0.00,$2884.72,Print
5/10/2020,$2.84,$0.00,$2887.50,Print
5/10/2020,$2.78,$0.00,$2890.34,Print
5/10/2020,$2.78,$0.00,$2893.12,Print
5/10/2020,$2.76,$0.00,$2895.90,Print
5/10/2020,$2.78,$0.00,$2898.66,Print
5/10/2020,$2.78,$0.00,$2901.44,Print
5/10/2020,$2.84,$0.00,$2904.22,Print
5/10/2020,$2.74,$0.00,$2907.06,Print
5/10/2020,$2.76,$0.00,$2909.80,Print
5/10/2020,$2.84,$0.00,$2912.56,Print
5/10/2020,$2.78,$0.00,$2915.40,Print
5/10/2020,$2.76,$0.00,$2918.18,Print
5/10/2020,$2.78,$0.00,$2920.94,Print
5/10/2020,$2.84,$0.00,$2923.72,Print
5/10/2020,$2.74,$0.00,$2926.56,Print
5/10/2020,$2.78,$0.00,$2929.30,Print
5/10/2020,$2.84,$0.00,$2932.08,Print
5/10/2020,$2.78,$0.00,$2934.92,Print
5/10/2020,$2.84,$0.00,$2937.70,Print
5/10/2020,$2.74,$0.00,$2940.54,Print
5/10/2020,$2.78,$0.00,$2943.28,Print
5/10/2020,$2.84,$0.00,$2946.06,Print
5/10/2020,$2.84,$0.00,$2948.90,Print
5/10/2020,$2.76,$0.00,$2951.74,Print
5/10/2020,$8.12,$0.00,$2954.50,Print
5/10/2020,$2.78,$0.00,$2962.62,Print
5/10/2020,$2.84,$0.00,$2965.40,Print
5/10/2020,$2.84,$0.00,$2968.24,Print
5/10/2020,$2.84,$0.00,$2971.08,Print
5/10/2020,$2.78,$0.00,$2973.92,Print
5/10/2020,$2.76,$0.00,$2976.70,Print
5/10/2020,$2.84,$0.00,$2979.46,Print
5/10/2020,$2.78,$0.00,$2982.30,Print
5/10/2020,$2.84,$0.00,$2985.08,Print
5/10/2020,$3.23,$0.00,$2987.92,Print
5/10/2020,$3.31,$0.00,$2991.15,Print
5/10/2020,$2.84,$0.00,$2994.46,Print
5/10/2020,$2.74,$0.00,$2997.30,Print
5/10/2020,$2.84,$0.00,$3000.04,Print
5/10/2020,$2.76,$0.00,$3002.88,Print
5/10/2020,$2.84,$0.00,$3005.64,Print
5/10/2020,$2.78,$0.00,$3008.48,Print
5/10/2020,$2.84,$0.00,$3011.26,Print
5/10/2020,$2.74,$0.00,$3014.10,Print
5/10/2020,$2.78,$0.00,$3016.84,Print
5/10/2020,$2.84,$0.00,$3019.62,Print
5/10/2020,$2.76,$0.00,$3022.46,Print
5/10/2020,$2.74,$0.00,$3025.22,Print
5/10/2020,$2.84,$0.00,$3027.96,Print
5/10/2020,$2.76,$0.00,$3030.80,Print
5/10/2020,$2.84,$0.00,$3033.56,Print
5/10/2020,$2.78,$0.00,$3036.40,Print
5/10/2020,$2.76,$0.00,$3039.18,Print
5/10/2020,$2.84,$0.00,$3041.94,Print
5/10/2020,$2.78,$0.00,$3044.78,Print
5/10/2020,$2.78,$0.00,$3047.56,Print
5/10/2020,$2.74,$0.00,$3050.34,Print
5/10/2020,$2.78,$0.00,$3053.08,Print
5/10/2020,$2.78,$0.00,$3055.86,Print
5/10/2020,$2.74,$0.00,$3058.64,Print
5/10/2020,$3.25,$0.00,$3061.38,Print
5/10/2020,$2.84,$0.00,$3064.63,Print
5/10/2020,$2.78,$0.00,$3067.47,Print
5/10/2020,$2.84,$0.00,$3070.25,Print
5/10/2020,$2.78,$0.00,$3073.09,Print
5/10/2020,$2.84,$0.00,$3075.87,Print
5/10/2020,$3.31,$0.00,$3078.71,Print
5/10/2020,$2.74,$0.00,$3082.02,Print
5/10/2020,$3.31,$0.00,$3084.76,Print
5/10/2020,$3.23,$0.00,$3088.07,Print
5/10/2020,$2.78,$0.00,$3091.30,Print
5/10/2020,$2.78,$0.00,$3094.08,Print
5/10/2020,$2.93,$0.00,$3096.86,Print
5/10/2020,$2.78,$0.00,$3099.79,Print
5/10/2020,$2.74,$0.00,$3102.57,Print
5/10/2020,$3.23,$0.00,$3105.31,Print
5/10/2020,$2.74,$0.00,$3108.54,Print
5/10/2020,$3.21,$0.00,$3111.28,Print
5/10/2020,$3.25,$0.00,$3114.49,Print
5/10/2020,$4.00,$0.00,$3117.74,Print
5/10/2020,$4.00,$0.00,$3121.74,Print
5/10/2020,$3.21,$0.00,$3125.74,Print
5/10/2020,$3.05,$0.00,$3128.95,Print
5/10/2020,$2.84,$0.00,$3132.00,Print
5/10/2020,$2.74,$0.00,$3134.84,Print
5/10/2020,$3.23,$0.00,$3137.58,Print
5/10/2020,$2.78,$0.00,$3140.81,Print
5/10/2020,$2.74,$0.00,$3143.59,Print
5/10/2020,$2.74,$0.00,$3146.33,Print
5/10/2020,$2.74,$0.00,$3149.07,Print
5/10/2020,$2.76,$0.00,$3151.81,Print
5/10/2020,$2.74,$0.00,$3154.57,Print
5/10/2020,$2.76,$0.00,$3157.31,Print
5/10/2020,$3.21,$0.00,$3160.07,Print
5/10/2020,$2.74,$0.00,$3163.28,Print
5/10/2020,$2.84,$0.00,$3166.02,Print
5/10/2020,$3.97,$0.00,$3168.86,Print
5/10/2020,$2.84,$0.00,$3172.83,Print
5/10/2020,$4.00,$0.00,$3175.67,Print
5/10/2020,$2.84,$0.00,$3179.67,Print
5/10/2020,$3.31,$0.00,$3182.51,Print
5/10/2020,$2.76,$0.00,$3185.82,Print
5/10/2020,$2.78,$0.00,$3188.58,Print
5/10/2020,$2.76,$0.00,$3191.36,Print
5/10/2020,$2.84,$0.00,$3194.12,Print
5/10/2020,$2.84,$0.00,$3196.96,Print
5/10/2020,$5.12,$0.00,$3199.80,Print
5/10/2020,$3.25,$0.00,$3204.92,Print
5/10/2020,$2.76,$0.00,$3208.17,Print
5/10/2020,$2.78,$0.00,$3210.93,Print
5/10/2020,$2.78,$0.00,$3213.71,Print
5/10/2020,$2.74,$0.00,$3216.49,Print
5/10/2020,$2.76,$0.00,$3219.23,Print
5/10/2020,$2.76,$0.00,$3221.99,Print
5/10/2020,$2.74,$0.00,$3224.75,Print
5/10/2020,$2.76,$0.00,$3227.49,Print
5/10/2020,$2.78,$0.00,$3230.25,Print
5/10/2020,$2.74,$0.00,$3233.03,Print
5/10/2020,$2.74,$0.00,$3235.77,Print
5/10/2020,$2.74,$0.00,$3238.51,Print
5/10/2020,$2.84,$0.00,$3241.25,Print
5/10/2020,$2.76,$0.00,$3244.09,Print
5/10/2020,$2.76,$0.00,$3246.85,Print
5/10/2020,$2.84,$0.00,$3249.61,Print
5/10/2020,$2.84,$0.00,$3252.45,Print
5/10/2020,$3.05,$0.00,$3255.29,Print
5/10/2020,$2.84,$0.00,$3258.34,Print
5/10/2020,$2.74,$0.00,$3261.18,Print
5/10/2020,$3.05,$0.00,$3263.92,Print
5/10/2020,$2.76,$0.00,$3266.97,Print
5/10/2020,$3.05,$0.00,$3269.73,Print
5/10/2020,$3.18,$0.00,$3272.78,Print
5/10/2020,$3.25,$0.00,$3275.96,Print
5/10/2020,$2.78,$0.00,$3279.21,Print
5/10/2020,$2.76,$0.00,$3281.99,Print
5/10/2020,$3.52,$0.00,$3284.75,Print
5/10/2020,$2.78,$0.00,$3288.27,Print
5/10/2020,$3.23,$0.00,$3291.05,Print
5/10/2020,$2.78,$0.00,$3294.28,Print
5/10/2020,$3.21,$0.00,$3297.06,Print
5/10/2020,$2.84,$0.00,$3300.27,Print
5/10/2020,$2.78,$0.00,$3303.11,Print
5/10/2020,$2.78,$0.00,$3305.89,Print
5/10/2020,$2.76,$0.00,$3308.67,Print
5/10/2020,$2.74,$0.00,$3311.43,Print
5/10/2020,$2.84,$0.00,$3314.17,Print
5/10/2020,$2.74,$0.00,$3317.01,Print
5/10/2020,$2.93,$0.00,$3319.75,Print
5/10/2020,$2.74,$0.00,$3322.68,Print
5/10/2020,$8.76,$0.00,$3325.42,Print
5/10/2020,$2.74,$0.00,$3334.18,Print
5/10/2020,$2.74,$0.00,$3336.92,Print
5/10/2020,$2.84,$0.00,$3339.66,Print
5/10/2020,$3.23,$0.00,$3342.50,Print
5/10/2020,$2.78,$0.00,$3345.73,Print
5/10/2020,$2.84,$0.00,$3348.51,Print
5/10/2020,$2.78,$0.00,$3351.35,Print
5/10/2020,$2.74,$0.00,$3354.13,Print
5/10/2020,$2.78,$0.00,$3356.87,Print
5/10/2020,$2.76,$0.00,$3359.65,Print
5/10/2020,$3.21,$0.00,$3362.41,Print
5/10/2020,$2.76,$0.00,$3365.62,Print
5/10/2020,$3.25,$0.00,$3368.38,Print
5/10/2020,$2.74,$0.00,$3371.63,Print
5/10/2020,$2.74,$0.00,$3374.37,Print
5/10/2020,$2.76,$0.00,$3377.11,Print
5/10/2020,$2.84,$0.00,$3379.87,Print
5/10/2020,$2.78,$0.00,$3382.71,Print
5/10/2020,$2.78,$0.00,$3385.49,Print
5/10/2020,$2.84,$0.00,$3388.27,Print
5/10/2020,$2.78,$0.00,$3391.11,Print
5/10/2020,$2.76,$0.00,$3393.89,Print
5/10/2020,$2.84,$0.00,$3396.65,Print
5/10/2020,$2.76,$0.00,$3399.49,Print
5/10/2020,$3.52,$0.00,$3402.25,Print
5/10/2020,$3.21,$0.00,$3405.77,Print
5/10/2020,$2.78,$0.00,$3408.98,Print
5/10/2020,$2.74,$0.00,$3411.76,Print
5/10/2020,$2.84,$0.00,$3414.50,Print
5/10/2020,$2.76,$0.00,$3417.34,Print
5/10/2020,$3.21,$0.00,$3420.10,Print
5/10/2020,$2.84,$0.00,$3423.31,Print
5/10/2020,$3.25,$0.00,$3426.15,Print
5/10/2020,$2.74,$0.00,$3429.40,Print
5/10/2020,$2.74,$0.00,$3432.14,Print
5/10/2020,$2.84,$0.00,$3434.88,Print
5/10/2020,$2.76,$0.00,$3437.72,Print
5/10/2020,$2.74,$0.00,$3440.48,Print
5/10/2020,$2.74,$0.00,$3443.22,Print
5/10/2020,$2.78,$0.00,$3445.96,Print
5/10/2020,$2.78,$0.00,$3448.74,Print
5/10/2020,$2.78,$0.00,$3451.52,Print
5/10/2020,$2.76,$0.00,$3454.30,Print
5/10/2020,$2.76,$0.00,$3457.06,Print
5/10/2020,$2.74,$0.00,$3459.82,Print
5/10/2020,$3.39,$0.00,$3462.56,Print
5/10/2020,$3.25,$0.00,$3465.95,Print
5/10/2020,$2.74,$0.00,$3469.20,Print
5/10/2020,$2.74,$0.00,$3471.94,Print
5/10/2020,$3.25,$0.00,$3474.68,Print
5/10/2020,$3.25,$0.00,$3477.93,Print
5/10/2020,$2.74,$0.00,$3481.18,Print
5/10/2020,$3.31,$0.00,$3483.92,Print
5/10/2020,$3.31,$0.00,$3487.23,Print
5/10/2020,$2.84,$0.00,$3490.54,Print
5/10/2020,$3.21,$0.00,$3493.38,Print
5/10/2020,$3.21,$0.00,$3496.59,Print
5/10/2020,$3.25,$0.00,$3499.80,Print
5/10/2020,$2.84,$0.00,$3503.05,Print
5/10/2020,$3.25,$0.00,$3505.89,Print
5/10/2020,$2.74,$0.00,$3509.14,Print
5/10/2020,$2.78,$0.00,$3511.88,Print
5/10/2020,$3.23,$0.00,$3514.66,Print
5/10/2020,$2.78,$0.00,$3517.89,Print
5/10/2020,$4.08,$0.00,$3520.67,Print
5/10/2020,$3.05,$0.00,$3524.75,Print
5/10/2020,$2.78,$0.00,$3527.80,Print
5/10/2020,$2.74,$0.00,$3530.58,Print
5/10/2020,$2.74,$0.00,$3533.32,Print
5/10/2020,$2.93,$0.00,$3536.06,Print
5/10/2020,$2.84,$0.00,$3538.99,Print
5/10/2020,$2.84,$0.00,$3541.83,Print
5/10/2020,$2.78,$0.00,$3544.67,Print
5/10/2020,$2.84,$0.00,$3547.45,Print
5/10/2020,$2.74,$0.00,$3550.29,Print
5/10/2020,$2.76,$0.00,$3553.03,Print
5/10/2020,$2.74,$0.00,$3555.79,Print
5/10/2020,$2.84,$0.00,$3558.53,Print
5/10/2020,$2.78,$0.00,$3561.37,Print
5/10/2020,$2.84,$0.00,$3564.15,Print
5/10/2020,$2.78,$0.00,$3566.99,Print
5/10/2020,$2.76,$0.00,$3569.77,Print
5/10/2020,$3.23,$0.00,$3572.53,Print
5/10/2020,$2.78,$0.00,$3575.76,Print
5/10/2020,$2.74,$0.00,$3578.54,Print
5/10/2020,$2.78,$0.00,$3581.28,Print
5/10/2020,$4.18,$0.00,$3584.06,Print
5/10/2020,$2.74,$0.00,$3588.24,Print
5/10/2020,$2.76,$0.00,$3590.98,Print
5/10/2020,$2.84,$0.00,$3593.74,Print
5/10/2020,$2.78,$0.00,$3596.58,Print
5/10/2020,$2.74,$0.00,$3599.36,Print
5/10/2020,$2.78,$0.00,$3602.10,Print
5/10/2020,$2.84,$0.00,$3604.88,Print
5/10/2020,$3.21,$0.00,$3607.72,Print
5/10/2020,$4.00,$0.00,$3610.93,Print
5/10/2020,$2.76,$0.00,$3614.93,Print
5/10/2020,$2.74,$0.00,$3617.69,Print
5/10/2020,$2.74,$0.00,$3620.43,Print
5/10/2020,$2.74,$0.00,$3623.17,Print
5/10/2020,$5.12,$0.00,$3625.91,Print
5/10/2020,$2.76,$0.00,$3631.03,Print
5/10/2020,$2.76,$0.00,$3633.79,Print
5/10/2020,$2.78,$0.00,$3636.55,Print
5/10/2020,$2.84,$0.00,$3639.33,Print
5/10/2020,$2.74,$0.00,$3642.17,Print
5/10/2020,$2.74,$0.00,$3644.91,Print
5/10/2020,$2.78,$0.00,$3647.65,Print
5/10/2020,$2.74,$0.00,$3650.43,Print
5/10/2020,$3.31,$0.00,$3653.17,Print
5/10/2020,$3.25,$0.00,$3656.48,Print
5/10/2020,$2.78,$0.00,$3659.73,Print
5/10/2020,$2.76,$0.00,$3662.51,Print
5/10/2020,$5.27,$0.00,$3665.27,Print
5/10/2020,$2.78,$0.00,$3670.54,Print
5/10/2020,$2.78,$0.00,$3673.32,Print
5/10/2020,$3.23,$0.00,$3676.10,Print
5/10/2020,$2.78,$0.00,$3679.33,Print
5/10/2020,$2.74,$0.00,$3682.11,Print
5/10/2020,$5.08,$0.00,$3684.85,Print
5/10/2020,$2.74,$0.00,$3689.93,Print
5/10/2020,$3.93,$0.00,$3692.67,Print
5/10/2020,$5.12,$0.00,$3696.60,Print
5/10/2020,$4.00,$0.00,$3701.72,Print
5/10/2020,$2.84,$0.00,$3705.72,Print
5/10/2020,$2.93,$0.00,$3708.56,Print
5/10/2020,$3.25,$0.00,$3711.49,Print
5/10/2020,$2.84,$0.00,$3714.74,Print
5/10/2020,$2.78,$0.00,$3717.58,Print
5/10/2020,$2.74,$0.00,$3720.36,Print
5/10/2020,$2.74,$0.00,$3723.10,Print
5/10/2020,$2.84,$0.00,$3725.84,Print
5/10/2020,$2.74,$0.00,$3728.68,Print
5/10/2020,$3.97,$0.00,$3731.42,Print
5/10/2020,$2.76,$0.00,$3735.39,Print
5/10/2020,$2.76,$0.00,$3738.15,Print
5/10/2020,$2.78,$0.00,$3740.91,Print
5/10/2020,$2.84,$0.00,$3743.69,Print
5/10/2020,$2.84,$0.00,$3746.53,Print
5/10/2020,$2.84,$0.00,$3749.37,Print
5/10/2020,$3.21,$0.00,$3752.21,Print
5/10/2020,$2.76,$0.00,$3755.42,Print
5/10/2020,$4.00,$0.00,$3758.18,Print
5/10/2020,$2.74,$0.00,$3762.18,Print
5/10/2020,$3.21,$0.00,$3764.92,Print
5/10/2020,$2.84,$0.00,$3768.13,Print
5/10/2020,$2.84,$0.00,$3770.97,Print
5/10/2020,$2.76,$0.00,$3773.81,Print
5/10/2020,$2.84,$0.00,$3776.57,Print
5/10/2020,$2.78,$0.00,$3779.41,Print
5/10/2020,$3.23,$0.00,$3782.19,Print
5/10/2020,$3.23,$0.00,$3785.42,Print
5/10/2020,$2.74,$0.00,$3788.65,Print
5/10/2020,$2.74,$0.00,$3791.39,Print
5/10/2020,$2.76,$0.00,$3794.13,Print
5/10/2020,$2.76,$0.00,$3796.89,Print
5/10/2020,$2.78,$0.00,$3799.65,Print
5/10/2020,$2.76,$0.00,$3802.43,Print
5/10/2020,$2.74,$0.00,$3805.19,Print
5/10/2020,$3.25,$0.00,$3807.93,Print
5/10/2020,$2.78,$0.00,$3811.18,Print
5/10/2020,$2.74,$0.00,$3813.96,Print
5/10/2020,$2.78,$0.00,$3816.70,Print
5/10/2020,$2.76,$0.00,$3819.48,Print
5/10/2020,$2.78,$0.00,$3822.24,Print
5/10/2020,$2.93,$0.00,$3825.02,Print
5/10/2020,$2.76,$0.00,$3827.95,Print
5/10/2020,$2.74,$0.00,$3830.71,Print
5/10/2020,$2.84,$0.00,$3833.45,Print
5/10/2020,$2.74,$0.00,$3836.29,Print
5/10/2020,$2.76,$0.00,$3839.03,Print
5/10/2020,$3.25,$0.00,$3841.79,Print
5/10/2020,$2.78,$0.00,$3845.04,Print
5/10/2020,$2.78,$0.00,$3847.82,Print
5/10/2020,$3.21,$0.00,$3850.60,Print
5/10/2020,$2.74,$0.00,$3853.81,Print
5/10/2020,$2.84,$0.00,$3856.55,Print
5/10/2020,$2.76,$0.00,$3859.39,Print
5/10/2020,$2.84,$0.00,$3862.15,Print
5/10/2020,$2.78,$0.00,$3864.99,Print
5/10/2020,$2.78,$0.00,$3867.77,Print
5/10/2020,$2.78,$0.00,$3870.55,Print
5/10/2020,$2.84,$0.00,$3873.33,Print
5/10/2020,$2.84,$0.00,$3876.17,Print
5/10/2020,$2.74,$0.00,$3879.01,Print
5/10/2020,$2.78,$0.00,$3881.75,Print
5/10/2020,$2.78,$0.00,$3884.53,Print
5/10/2020,$2.74,$0.00,$3887.31,Print
5/10/2020,$2.84,$0.00,$3890.05,Print
5/10/2020,$2.78,$0.00,$3892.89,Print
5/10/2020,$2.84,$0.00,$3895.67,Print
5/10/2020,$2.76,$0.00,$3898.51,Print
5/10/2020,$2.76,$0.00,$3901.27,Print
5/10/2020,$3.05,$0.00,$3904.03,Print
5/10/2020,$3.25,$0.00,$3907.08,Print
5/10/2020,$3.23,$0.00,$3910.33,Print
5/10/2020,$3.25,$0.00,$3913.56,Print
5/10/2020,$3.39,$0.00,$3916.81,Print
5/10/2020,$2.74,$0.00,$3920.20,Print
5/10/2020,$2.76,$0.00,$3922.94,Print
5/10/2020,$3.31,$0.00,$3925.70,Print
5/10/2020,$2.84,$0.00,$3929.01,Print
5/10/2020,$5.40,$0.00,$3931.85,Print
5/10/2020,$2.84,$0.00,$3937.25,Print
5/10/2020,$2.76,$0.00,$3940.09,Print
5/10/2020,$3.31,$0.00,$3942.85,Print
5/10/2020,$2.78,$0.00,$3946.16,Print
5/10/2020,$2.74,$0.00,$3948.94,Print
5/10/2020,$2.78,$0.00,$3951.68,Print
5/10/2020,$2.74,$0.00,$3954.46,Print
5/10/2020,$2.76,$0.00,$3957.20,Print
5/10/2020,$2.74,$0.00,$3959.96,Print
5/10/2020,$2.76,$0.00,$3962.70,Print
5/10/2020,$2.76,$0.00,$3965.46,Print
5/10/2020,$2.84,$0.00,$3968.22,Print
5/10/2020,$2.76,$0.00,$3971.06,Print
5/10/2020,$2.78,$0.00,$3973.82,Print
5/10/2020,$2.76,$0.00,$3976.60,Print
5/10/2020,$2.84,$0.00,$3979.36,Print
5/10/2020,$2.76,$0.00,$3982.20,Print
5/10/2020,$2.76,$0.00,$3984.96,Print
5/10/2020,$2.74,$0.00,$3987.72,Print
5/10/2020,$2.84,$0.00,$3990.46,Print
5/10/2020,$2.74,$0.00,$3993.30,Print
5/10/2020,$2.74,$0.00,$3996.04,Print
5/10/2020,$2.84,$0.00,$3998.78,Print
5/10/2020,$2.76,$0.00,$4001.62,Print
5/10/2020,$3.31,$0.00,$4004.38,Print
5/10/2020,$2.76,$0.00,$4007.69,Print
5/10/2020,$2.74,$0.00,$4010.45,Print
5/10/2020,$2.78,$0.00,$4013.19,Print
5/10/2020,$2.78,$0.00,$4015.97,Print
5/10/2020,$2.78,$0.00,$4018.75,Print
5/10/2020,$2.74,$0.00,$4021.53,Print
5/10/2020,$2.74,$0.00,$4024.27,Print
5/10/2020,$5.12,$0.00,$4027.01,Print
5/10/2020,$2.78,$0.00,$4032.13,Print
5/10/2020,$2.76,$0.00,$4034.91,Print
5/10/2020,$2.76,$0.00,$4037.67,Print
5/10/2020,$3.23,$0.00,$4040.43,Print
5/10/2020,$2.74,$0.00,$4043.66,Print
5/10/2020,$3.25,$0.00,$4046.40,Print
5/10/2020,$3.21,$0.00,$4049.65,Print
5/10/2020,$2.76,$0.00,$4052.86,Print
5/10/2020,$3.25,$0.00,$4055.62,Print
5/10/2020,$3.25,$0.00,$4058.87,Print
5/10/2020,$2.74,$0.00,$4062.12,Print
5/10/2020,$2.78,$0.00,$4064.86,Print
5/10/2020,$3.21,$0.00,$4067.64,Print
5/10/2020,$3.25,$0.00,$4070.85,Print
5/10/2020,$3.25,$0.00,$4074.10,Print
5/10/2020,$3.25,$0.00,$4077.35,Print
5/10/2020,$3.25,$0.00,$4080.60,Print
5/10/2020,$4.00,$0.00,$4083.85,Print
5/10/2020,$3.25,$0.00,$4087.85,Print
5/10/2020,$3.23,$0.00,$4091.10,Print
5/10/2020,$2.84,$0.00,$4094.33,Print
5/10/2020,$3.23,$0.00,$4097.17,Print
5/10/2020,$3.25,$0.00,$4100.40,Print
5/10/2020,$4.32,$0.00,$4103.65,Print
5/10/2020,$3.25,$0.00,$4107.97,Print
5/10/2020,$3.21,$0.00,$4111.22,Print
5/10/2020,$4.32,$0.00,$4114.43,Print
5/10/2020,$2.84,$0.00,$4118.75,Print
5/10/2020,$2.84,$0.00,$4121.59,Print
5/10/2020,$3.25,$0.00,$4124.43,Print
5/10/2020,$3.52,$0.00,$4127.68,Print
5/10/2020,$4.08,$0.00,$4131.20,Print
5/10/2020,$2.84,$0.00,$4135.28,Print
5/10/2020,$3.25,$0.00,$4138.12,Print
5/10/2020,$3.23,$0.00,$4141.37,Print
5/10/2020,$3.25,$0.00,$4144.60,Print
5/10/2020,$3.93,$0.00,$4147.85,Print
5/10/2020,$3.25,$0.00,$4151.78,Print
5/10/2020,$3.25,$0.00,$4155.03,Print
5/10/2020,$2.84,$0.00,$4158.28,Print
5/10/2020,$2.78,$0.00,$4161.12,Print
5/10/2020,$2.84,$0.00,$4163.90,Print
5/10/2020,$2.78,$0.00,$4166.74,Print
5/10/2020,$2.74,$0.00,$4169.52,Print
5/10/2020,$2.78,$0.00,$4172.26,Print
5/10/2020,$3.21,$0.00,$4175.04,Print
5/10/2020,$2.78,$0.00,$4178.25,Print
5/10/2020,$2.93,$0.00,$4181.03,Print
5/10/2020,$3.21,$0.00,$4183.96,Print
5/10/2020,$2.74,$0.00,$4187.17,Print
5/10/2020,$3.31,$0.00,$4189.91,Print
5/10/2020,$4.08,$0.00,$4193.22,Print
5/10/2020,$3.21,$0.00,$4197.30,Print
5/10/2020,$3.25,$0.00,$4200.51,Print
5/10/2020,$3.25,$0.00,$4203.76,Print
5/9/2020,$5.27,$0.00,$4207.01,Print
5/9/2020,$2.74,$0.00,$4212.28,Print
5/9/2020,$3.25,$0.00,$4215.02,Print
5/9/2020,$3.93,$0.00,$4218.27,Print
5/9/2020,$5.08,$0.00,$4222.20,Print
5/9/2020,$2.78,$0.00,$4227.28,Print
5/9/2020,$2.78,$0.00,$4230.06,Print
5/9/2020,$2.84,$0.00,$4232.84,Print
5/9/2020,$2.78,$0.00,$4235.68,Print
5/9/2020,$3.31,$0.00,$4238.46,Print
5/9/2020,$2.78,$0.00,$4241.77,Print
5/9/2020,$2.74,$0.00,$4244.55,Print
5/9/2020,$2.74,$0.00,$4247.29,Print
5/9/2020,$2.78,$0.00,$4250.03,Print
5/9/2020,$2.74,$0.00,$4252.81,Print
5/9/2020,$2.78,$0.00,$4255.55,Print
5/9/2020,$3.31,$0.00,$4258.33,Print
5/9/2020,$2.74,$0.00,$4261.64,Print
5/9/2020,$2.84,$0.00,$4264.38,Print
5/9/2020,$2.78,$0.00,$4267.22,Print
5/9/2020,$2.84,$0.00,$4270.00,Print
5/9/2020,$2.78,$0.00,$4272.84,Print
5/9/2020,$2.78,$0.00,$4275.62,Print
5/9/2020,$2.74,$0.00,$4278.40,Print
5/9/2020,$2.74,$0.00,$4281.14,Print
5/9/2020,$2.78,$0.00,$4283.88,Print
5/9/2020,$3.31,$0.00,$4286.66,Print
5/9/2020,$2.78,$0.00,$4289.97,Print
5/9/2020,$2.74,$0.00,$4292.75,Print
5/9/2020,$2.78,$0.00,$4295.49,Print
5/9/2020,$2.78,$0.00,$4298.27,Print
5/9/2020,$5.04,$0.00,$4301.05,Print
5/9/2020,$3.31,$0.00,$4306.09,Print
5/9/2020,$2.76,$0.00,$4309.40,Print
5/9/2020,$2.78,$0.00,$4312.16,Print
5/9/2020,$3.31,$0.00,$4314.94,Print
5/9/2020,$3.21,$0.00,$4318.25,Print
5/9/2020,$3.21,$0.00,$4321.46,Print
5/9/2020,$3.21,$0.00,$4324.67,Print
5/9/2020,$3.25,$0.00,$4327.88,Print
5/9/2020,$3.21,$0.00,$4331.13,Print
5/9/2020,$2.84,$0.00,$4334.34,Print
5/9/2020,$3.25,$0.00,$4337.18,Print
5/9/2020,$3.25,$0.00,$4340.43,Print
5/9/2020,$3.25,$0.00,$4343.68,Print
5/9/2020,$3.25,$0.00,$4346.93,Print
5/9/2020,$3.21,$0.00,$4350.18,Print
5/9/2020,$3.31,$0.00,$4353.39,Print
5/9/2020,$5.12,$0.00,$4356.70,Print
5/9/2020,$3.21,$0.00,$4361.82,Print
5/9/2020,$3.31,$0.00,$4365.03,Print
5/9/2020,$3.25,$0.00,$4368.34,Print
5/9/2020,$3.23,$0.00,$4371.59,Print
5/9/2020,$5.12,$0.00,$4374.82,Print
5/9/2020,$4.32,$0.00,$4379.94,Print
5/9/2020,$3.52,$0.00,$4384.26,Print
5/9/2020,$3.25,$0.00,$4387.78,Print
5/9/2020,$3.23,$0.00,$4391.03,Print
5/9/2020,$3.21,$0.00,$4394.26,Print
5/9/2020,$3.52,$0.00,$4397.47,Print
5/9/2020,$3.21,$0.00,$4400.99,Print
5/9/2020,$5.12,$0.00,$4404.20,Print
5/9/2020,$4.32,$0.00,$4409.32,Print
5/9/2020,$3.25,$0.00,$4413.64,Print
5/9/2020,$3.21,$0.00,$4416.89,Print
5/9/2020,$3.93,$0.00,$4420.10,Print
5/9/2020,$3.93,$0.00,$4424.03,Print
5/9/2020,$2.84,$0.00,$4427.96,Print
5/9/2020,$3.25,$0.00,$4430.80,Print
5/9/2020,$4.32,$0.00,$4434.05,Print
5/9/2020,$3.25,$0.00,$4438.37,Print
5/9/2020,$3.67,$0.00,$4441.62,Print
5/9/2020,$3.21,$0.00,$4445.29,Print
5/9/2020,$3.18,$0.00,$4448.50,Print
5/9/2020,$4.00,$0.00,$4451.68,Print
5/9/2020,$3.23,$0.00,$4455.68,Print
5/9/2020,$3.21,$0.00,$4458.91,Print
5/9/2020,$2.78,$0.00,$4462.12,Print
5/9/2020,$4.00,$0.00,$4464.90,Print
5/9/2020,$2.78,$0.00,$4468.90,Print
5/9/2020,$3.25,$0.00,$4471.68,Print
5/9/2020,$2.84,$0.00,$4474.93,Print
5/9/2020,$2.78,$0.00,$4477.77,Print
5/9/2020,$2.74,$0.00,$4480.55,Print
5/9/2020,$2.74,$0.00,$4483.29,Print
5/9/2020,$2.78,$0.00,$4486.03,Print
5/9/2020,$2.74,$0.00,$4488.81,Print
5/9/2020,$3.25,$0.00,$4491.55,Print
5/9/2020,$3.67,$0.00,$4494.80,Print
5/9/2020,$2000.00,$0.00,$4498.47,Purchase
5/9/2020,$3.25,$0.00,$2498.47,Print
5/9/2020,$3.21,$0.00,$2501.72,Print
5/9/2020,$4.00,$0.00,$2504.93,Print
5/9/2020,$2.84,$0.00,$2508.93,Print
5/9/2020,$2.76,$0.00,$2511.77,Print
5/9/2020,$2.76,$0.00,$2514.53,Print
5/9/2020,$2.84,$0.00,$2517.29,Print
5/9/2020,$3.97,$0.00,$2520.13,Print
5/9/2020,$3.18,$0.00,$2524.10,Print
5/9/2020,$2.78,$0.00,$2527.28,Print
5/9/2020,$5.70,$0.00,$2530.06,Print
5/9/2020,$2.78,$0.00,$2535.76,Print
5/9/2020,$3.23,$0.00,$2538.54,Print
5/9/2020,$5.08,$0.00,$2541.77,Print
5/9/2020,$3.25,$0.00,$2546.85,Print
5/9/2020,$3.31,$0.00,$2550.10,Print
5/9/2020,$2.78,$0.00,$2553.41,Print
5/9/2020,$3.18,$0.00,$2556.19,Print
5/9/2020,$2.78,$0.00,$2559.37,Print
5/9/2020,$4.08,$0.00,$2562.15,Print
5/9/2020,$3.31,$0.00,$2566.23,Print
5/9/2020,$4.00,$0.00,$2569.54,Print
5/9/2020,$4.00,$0.00,$2573.54,Print
5/9/2020,$2.84,$0.00,$2577.54,Print
5/9/2020,$4.08,$0.00,$2580.38,Print
5/9/2020,$2.78,$0.00,$2584.46,Print
5/9/2020,$3.97,$0.00,$2587.24,Print
5/9/2020,$4.00,$0.00,$2591.21,Print
5/9/2020,$3.67,$0.00,$2595.21,Print
5/9/2020,$2.84,$0.00,$2598.88,Print
5/9/2020,$3.67,$0.00,$2601.72,Print
5/9/2020,$3.25,$0.00,$2605.39,Print
5/9/2020,$2.76,$0.00,$2608.64,Print
5/9/2020,$2.78,$0.00,$2611.40,Print
5/9/2020,$3.25,$0.00,$2614.18,Print
5/9/2020,$4.18,$0.00,$2617.43,Print
5/9/2020,$5.08,$0.00,$2621.61,Print
5/9/2020,$5.08,$0.00,$2626.69,Print
5/9/2020,$4.32,$0.00,$2631.77,Print
5/9/2020,$3.25,$0.00,$2636.09,Print
5/9/2020,$3.25,$0.00,$2639.34,Print
5/9/2020,$3.25,$0.00,$2642.59,Print
5/9/2020,$4.00,$0.00,$2645.84,Print
5/9/2020,$5.04,$0.00,$2649.84,Print
5/9/2020,$3.21,$0.00,$2654.88,Print
5/9/2020,$2.76,$0.00,$2658.09,Print
5/9/2020,$4.32,$0.00,$2660.85,Print
5/9/2020,$5.27,$0.00,$2665.17,Print
5/9/2020,$4.08,$0.00,$2670.44,Print
5/9/2020,$4.08,$0.00,$2674.52,Print
5/9/2020,$4.32,$0.00,$2678.60,Print
5/9/2020,$7.64,$0.00,$2682.92,Print
5/9/2020,$7.64,$0.00,$2690.56,Print
5/9/2020,$3.93,$0.00,$2698.20,Print
5/9/2020,$5.04,$0.00,$2702.13,Print
5/9/2020,$3.25,$0.00,$2707.17,Print
5/9/2020,$3.93,$0.00,$2710.42,Print
5/9/2020,$3.21,$0.00,$2714.35,Print
5/9/2020,$5.08,$0.00,$2717.56,Print
5/9/2020,$5.04,$0.00,$2722.64,Print
5/9/2020,$5.70,$0.00,$2727.68,Print
5/9/2020,$3.25,$0.00,$2733.38,Print
5/9/2020,$5.04,$0.00,$2736.63,Print
5/9/2020,$3.31,$0.00,$2741.67,Print
5/9/2020,$3.21,$0.00,$2744.98,Print
5/9/2020,$3.25,$0.00,$2748.19,Print
5/9/2020,$3.25,$0.00,$2751.44,Print
5/9/2020,$3.23,$0.00,$2754.69,Print
5/9/2020,$3.21,$0.00,$2757.92,Print
5/9/2020,$3.25,$0.00,$2761.13,Print
5/9/2020,$3.25,$0.00,$2764.38,Print
5/9/2020,$3.31,$0.00,$2767.63,Print
5/9/2020,$3.25,$0.00,$2770.94,Print
5/9/2020,$3.25,$0.00,$2774.19,Print
5/9/2020,$3.25,$0.00,$2777.44,Print
5/9/2020,$3.31,$0.00,$2780.69,Print
5/9/2020,$3.31,$0.00,$2784.00,Print
5/9/2020,$4.08,$0.00,$2787.31,Print
5/9/2020,$3.31,$0.00,$2791.39,Print
5/9/2020,$3.39,$0.00,$2794.70,Print
5/9/2020,$3.31,$0.00,$2798.09,Print
5/9/2020,$3.23,$0.00,$2801.40,Print
5/9/2020,$3.25,$0.00,$2804.63,Print
5/9/2020,$3.23,$0.00,$2807.88,Print
5/9/2020,$3.97,$0.00,$2811.11,Print
5/9/2020,$3.31,$0.00,$2815.08,Print
5/9/2020,$3.52,$0.00,$2818.39,Print
5/9/2020,$3.25,$0.00,$2821.91,Print
5/9/2020,$3.23,$0.00,$2825.16,Print
5/9/2020,$3.25,$0.00,$2828.39,Print
5/9/2020,$3.23,$0.00,$2831.64,Print
5/9/2020,$5.27,$0.00,$2834.87,Print
5/9/2020,$2.78,$0.00,$2840.14,Print
5/9/2020,$3.23,$0.00,$2842.92,Print
5/9/2020,$2.76,$0.00,$2846.15,Print
5/9/2020,$5.04,$0.00,$2848.91,Print
5/9/2020,$3.31,$0.00,$2853.95,Print
5/9/2020,$2.93,$0.00,$2857.26,Print
5/9/2020,$2.78,$0.00,$2860.19,Print
5/9/2020,$3.31,$0.00,$2862.97,Print
5/9/2020,$3.25,$0.00,$2866.28,Print
5/9/2020,$5.27,$0.00,$2869.53,Print
5/9/2020,$2.84,$0.00,$2874.80,Print
5/9/2020,$3.25,$0.00,$2877.64,Print
5/9/2020,$3.25,$0.00,$2880.89,Print
5/9/2020,$3.31,$0.00,$2884.14,Print
5/9/2020,$3.21,$0.00,$2887.45,Print
5/9/2020,$3.39,$0.00,$2890.66,Print
5/9/2020,$2.84,$0.00,$2894.05,Print
5/9/2020,$2.74,$0.00,$2896.89,Print
5/9/2020,$5.08,$0.00,$2899.63,Print
5/9/2020,$3.21,$0.00,$2904.71,Print
5/9/2020,$3.31,$0.00,$2907.92,Print
5/9/2020,$3.67,$0.00,$2911.23,Print
5/9/2020,$3.21,$0.00,$2914.90,Print
5/9/2020,$3.67,$0.00,$2918.11,Print
5/9/2020,$4.00,$0.00,$2921.78,Print
5/9/2020,$5.12,$0.00,$2925.78,Print
5/9/2020,$3.52,$0.00,$2930.90,Print
5/9/2020,$4.00,$0.00,$2934.42,Print
5/9/2020,$5.08,$0.00,$2938.42,Print
5/9/2020,$5.08,$0.00,$2943.50,Print
5/9/2020,$4.00,$0.00,$2948.58,Print
5/9/2020,$4.00,$0.00,$2952.58,Print
5/9/2020,$5.27,$0.00,$2956.58,Print
5/9/2020,$5.08,$0.00,$2961.85,Print
5/9/2020,$5.12,$0.00,$2966.93,Print
5/9/2020,$5.12,$0.00,$2972.05,Print
5/9/2020,$4.08,$0.00,$3019.66,Print
5/9/2020,$3.93,$0.00,$3023.74,Print
5/9/2020,$4.08,$0.00,$3027.67,Print
5/9/2020,$2.74,$0.00,$3031.75,Print
5/9/2020,$2.76,$0.00,$3034.49,Print
5/9/2020,$3.25,$0.00,$3037.25,Print
5/9/2020,$4.00,$0.00,$3040.50,Print
5/9/2020,$3.25,$0.00,$3044.50,Print
5/9/2020,$5.12,$0.00,$3047.75,Print
5/9/2020,$4.08,$0.00,$3052.87,Print
5/9/2020,$3.23,$0.00,$3056.95,Print
5/9/2020,$4.08,$0.00,$3060.18,Print
5/9/2020,$4.08,$0.00,$3064.26,Print
5/9/2020,$4.00,$0.00,$3068.34,Print

