Date,Cost,Credit,Balance,Type
5/24/2020,$2.76,$0.00,$4292.38,Print
5/24/2020,$2.74,$0.00,$4289.64,Print
5/24/2020,$2.78,$0.00,$4286.86,Print
5/24/2020,$2.78,$0.00,$4284.08,Print
5/24/2020,$2.84,$0.00,$4281.24,Print
5/24/2020,$2.78,$0.00,$4278.46,Print
5/24/2020,$2.74,$0.00,$4275.72,Print
5/24/2020,$3.21,$0.00,$4272.51,Print
5/24/2020,$2.78,$0.00,$4269.73,Print
5/24/2020,$3.25,$0.00,$4266.48,Print
5/24/2020,$2.78,$0.00,$4263.70,Print
5/24/2020,$2.78,$0.00,$4260.92,Print
5/24/2020,$2.78,$0.00,$4258.14,Print
5/24/2020,$2.74,$0.00,$4255.40,Print
5/24/2020,$3.31,$0.00,$4252.09,Print
5/24/2020,$2.76,$0.00,$4249.33,Print
5/24/2020,$7.56,$0.00,$4241.77,Print
5/24/2020,$2.74,$0.00,$4239.03,Print
5/24/2020,$2.74,$0.00,$4236.29,Print
5/24/2020,$3.25,$0.00,$4233.04,Print
5/24/2020,$2.78,$0.00,$4230.26,Print
5/24/2020,$2.76,$0.00,$4227.50,Print
5/24/2020,$2.74,$0.00,$4224.76,Print
5/24/2020,$2.78,$0.00,$4221.98,Print
5/24/2020,$2.74,$0.00,$4219.24,Print
5/24/2020,$2.74,$0.00,$4216.50,Print
5/24/2020,$2.78,$0.00,$4213.72,Print
5/24/2020,$2.76,$0.00,$4210.96,Print
5/24/2020,$2.84,$0.00,$4208.12,Print
5/24/2020,$3.52,$0.00,$4204.60,Print
5/24/2020,$2.74,$0.00,$4201.86,Print
5/24/2020,$2.74,$0.00,$4199.12,Print
5/24/2020,$2.84,$0.00,$4196.28,Print
5/24/2020,$3.97,$0.00,$4192.31,Print
5/24/2020,$2.74,$0.00,$4189.57,Print
5/24/2020,$2.84,$0.00,$4186.73,Print
5/24/2020,$3.21,$0.00,$4183.52,Print
5/24/2020,$2.78,$0.00,$4180.74,Print
5/24/2020,$2.74,$0.00,$4178.00,Print
5/24/2020,$2.74,$0.00,$4175.26,Print
5/24/2020,$2.78,$0.00,$4172.48,Print
5/24/2020,$2.74,$0.00,$4169.74,Print
5/24/2020,$3.52,$0.00,$4166.22,Print
5/24/2020,$2.74,$0.00,$4163.48,Print
5/24/2020,$2.78,$0.00,$4160.70,Print
5/24/2020,$4.32,$0.00,$4156.38,Print
5/24/2020,$5.04,$0.00,$4151.34,Print
5/24/2020,$2.78,$0.00,$4148.56,Print
5/24/2020,$3.52,$0.00,$4145.04,Print
5/24/2020,$5.27,$0.00,$4139.77,Print
5/24/2020,$2.84,$0.00,$4136.93,Print
5/24/2020,$3.25,$0.00,$4133.68,Print
5/24/2020,$3.25,$0.00,$4130.43,Print
5/24/2020,$5.27,$0.00,$4125.16,Print
5/24/2020,$5.70,$0.00,$4119.46,Print
5/24/2020,$4.00,$0.00,$4115.46,Print
5/24/2020,$4.00,$0.00,$4111.46,Print
5/24/2020,$3.97,$0.00,$4107.49,Print
5/24/2020,$2.84,$0.00,$4104.65,Print
5/24/2020,$2.84,$0.00,$4101.81,Print
5/24/2020,$2.84,$0.00,$4098.97,Print
5/24/2020,$2.84,$0.00,$4096.13,Print
5/24/2020,$2.84,$0.00,$4093.29,Print
5/24/2020,$3.31,$0.00,$4089.98,Print
5/24/2020,$2.78,$0.00,$4087.20,Print
5/24/2020,$4.08,$0.00,$4083.12,Print
5/24/2020,$2.78,$0.00,$4080.34,Print
5/24/2020,$3.31,$0.00,$4077.03,Print
5/24/2020,$2.78,$0.00,$4074.25,Print
5/24/2020,$2.74,$0.00,$4071.51,Print
5/24/2020,$2.74,$0.00,$4068.77,Print
5/24/2020,$2.74,$0.00,$4066.03,Print
5/24/2020,$2.78,$0.00,$4063.25,Print
5/24/2020,$2.78,$0.00,$4060.47,Print
5/24/2020,$2.78,$0.00,$4057.69,Print
5/24/2020,$2.76,$0.00,$4054.93,Print
5/24/2020,$2.74,$0.00,$4052.19,Print
5/24/2020,$3.25,$0.00,$4048.94,Print
5/24/2020,$2.78,$0.00,$4046.16,Print
5/24/2020,$2.76,$0.00,$4043.40,Print
5/24/2020,$2.84,$0.00,$4040.56,Print
5/24/2020,$2.74,$0.00,$4037.82,Print
5/24/2020,$2.74,$0.00,$4035.08,Print
5/24/2020,$3.18,$0.00,$4031.90,Print
5/24/2020,$2.84,$0.00,$4029.06,Print
5/24/2020,$2.74,$0.00,$4026.32,Print
5/24/2020,$3.21,$0.00,$4023.11,Print
5/24/2020,$2.74,$0.00,$4020.37,Print
5/24/2020,$3.25,$0.00,$4017.12,Print
5/24/2020,$3.31,$0.00,$4013.81,Print
5/24/2020,$2.78,$0.00,$4011.03,Print
5/24/2020,$3.25,$0.00,$4007.78,Print
5/24/2020,$4.00,$0.00,$4003.78,Print
5/24/2020,$3.52,$0.00,$4000.26,Print
5/24/2020,$3.31,$0.00,$3996.95,Print
5/24/2020,$3.52,$0.00,$3993.43,Print
5/24/2020,$2.74,$0.00,$3990.69,Print
5/24/2020,$3.21,$0.00,$3987.48,Print
5/24/2020,$3.31,$0.00,$3984.17,Print
5/24/2020,$3.21,$0.00,$3980.96,Print
5/24/2020,$2.74,$0.00,$3978.22,Print
5/24/2020,$5.12,$0.00,$3973.10,Print
5/24/2020,$2.78,$0.00,$3970.32,Print
5/24/2020,$2.84,$0.00,$3967.48,Print
5/24/2020,$2.84,$0.00,$3964.64,Print
5/24/2020,$2.74,$0.00,$3961.90,Print
5/24/2020,$3.93,$0.00,$3957.97,Print
5/24/2020,$2.84,$0.00,$3955.13,Print
5/24/2020,$2.74,$0.00,$3952.39,Print
5/24/2020,$4.00,$0.00,$3948.39,Print
5/24/2020,$2.76,$0.00,$3945.63,Print
5/24/2020,$2.76,$0.00,$3942.87,Print
5/24/2020,$2.84,$0.00,$3940.03,Print
5/24/2020,$2.84,$0.00,$3937.19,Print
5/24/2020,$2.76,$0.00,$3934.43,Print
5/24/2020,$2.84,$0.00,$3931.59,Print
5/24/2020,$3.97,$0.00,$3927.62,Print
5/24/2020,$4.18,$0.00,$3923.44,Print
5/24/2020,$3.39,$0.00,$3920.05,Print
5/24/2020,$4.32,$0.00,$3915.73,Print
5/24/2020,$2.76,$0.00,$3912.97,Print
5/24/2020,$3.67,$0.00,$3909.30,Print
5/24/2020,$3.25,$0.00,$3906.05,Print
5/24/2020,$3.25,$0.00,$3902.80,Print
5/24/2020,$4.00,$0.00,$3898.80,Print
5/24/2020,$3.23,$0.00,$3895.57,Print
5/24/2020,$3.21,$0.00,$3892.36,Print
5/24/2020,$2.74,$0.00,$3889.62,Print
5/24/2020,$3.21,$0.00,$3886.41,Print
5/24/2020,$4.08,$0.00,$3882.33,Print
5/24/2020,$3.25,$0.00,$3879.08,Print
5/24/2020,$3.97,$0.00,$3875.11,Print
5/24/2020,$2.84,$0.00,$3872.27,Print
5/24/2020,$3.25,$0.00,$3869.02,Print
5/24/2020,$3.31,$0.00,$3865.71,Print
5/24/2020,$3.31,$0.00,$3862.40,Print
5/24/2020,$2.93,$0.00,$3859.47,Print
5/24/2020,$3.21,$0.00,$3856.26,Print
5/24/2020,$3.21,$0.00,$3853.05,Print
5/24/2020,$3.31,$0.00,$3849.74,Print
5/24/2020,$3.97,$0.00,$3845.77,Print
5/24/2020,$4.00,$0.00,$3841.77,Print
5/24/2020,$3.93,$0.00,$3837.84,Print
5/24/2020,$2.74,$0.00,$3835.10,Print
5/24/2020,$2.78,$0.00,$3832.32,Print
5/24/2020,$2.74,$0.00,$3829.58,Print
5/24/2020,$2.74,$0.00,$3826.84,Print
5/24/2020,$2.76,$0.00,$3824.08,Print
5/24/2020,$3.23,$0.00,$3820.85,Print
5/24/2020,$4.00,$0.00,$3816.85,Print
5/24/2020,$3.25,$0.00,$3813.60,Print
5/24/2020,$4.00,$0.00,$3809.60,Print
5/24/2020,$2.76,$0.00,$3806.84,Print
5/24/2020,$3.52,$0.00,$3803.32,Print
5/24/2020,$3.93,$0.00,$3799.39,Print
5/24/2020,$2.78,$0.00,$3796.61,Print
5/24/2020,$2.76,$0.00,$3793.85,Print
5/24/2020,$2.84,$0.00,$3791.01,Print
5/24/2020,$3.67,$0.00,$3787.34,Print
5/24/2020,$2.74,$0.00,$3784.60,Print
5/24/2020,$4.32,$0.00,$3780.28,Print
5/24/2020,$3.25,$0.00,$3777.03,Print
5/24/2020,$3.21,$0.00,$3773.82,Print
5/24/2020,$4.00,$0.00,$3769.82,Print
5/24/2020,$4.08,$0.00,$3765.74,Print
5/24/2020,$4.00,$0.00,$3761.74,Print
5/24/2020,$4.32,$0.00,$3757.42,Print
5/24/2020,$4.00,$0.00,$3753.42,Print
5/24/2020,$4.32,$0.00,$3749.10,Print
5/24/2020,$3.93,$0.00,$3745.17,Print
5/24/2020,$3.97,$0.00,$3741.20,Print
5/24/2020,$4.00,$0.00,$3737.20,Print
5/24/2020,$2.76,$0.00,$3734.44,Print
5/24/2020,$3.21,$0.00,$3731.23,Print
5/24/2020,$2.84,$0.00,$3728.39,Print
5/24/2020,$2.78,$0.00,$3725.61,Print
5/24/2020,$3.52,$0.00,$3722.09,Print
5/24/2020,$2.78,$0.00,$3719.31,Print
5/24/2020,$3.97,$0.00,$3715.34,Print
5/24/2020,$2.84,$0.00,$3712.50,Print
5/24/2020,$3.93,$0.00,$3708.57,Print
5/24/2020,$3.21,$0.00,$3705.36,Print
5/24/2020,$2.78,$0.00,$3702.58,Print
5/24/2020,$3.23,$0.00,$3699.35,Print
5/24/2020,$3.25,$0.00,$3696.10,Print
5/24/2020,$2.74,$0.00,$3693.36,Print
5/24/2020,$3.21,$0.00,$3690.15,Print
5/24/2020,$2.78,$0.00,$3687.37,Print
5/24/2020,$3.25,$0.00,$3684.12,Print
5/24/2020,$2.84,$0.00,$3681.28,Print
5/24/2020,$3.21,$0.00,$3678.07,Print
5/24/2020,$2.76,$0.00,$3675.31,Print
5/24/2020,$3.21,$0.00,$3672.10,Print
5/24/2020,$2.76,$0.00,$3669.34,Print
5/24/2020,$3.23,$0.00,$3666.11,Print
5/24/2020,$3.21,$0.00,$3662.90,Print
5/24/2020,$3.25,$0.00,$3659.65,Print
5/24/2020,$3.21,$0.00,$3656.44,Print
5/24/2020,$3.25,$0.00,$3653.19,Print
5/24/2020,$2.74,$0.00,$3650.45,Print
5/24/2020,$2.78,$0.00,$3647.67,Print
5/24/2020,$5.04,$0.00,$3642.63,Print
5/24/2020,$3.21,$0.00,$3639.42,Print
5/24/2020,$2.78,$0.00,$3636.64,Print
5/24/2020,$3.23,$0.00,$3633.41,Print
5/24/2020,$3.23,$0.00,$3630.18,Print
5/24/2020,$2.74,$0.00,$3627.44,Print
5/24/2020,$3.93,$0.00,$3623.51,Print
5/24/2020,$4.18,$0.00,$3619.33,Print
5/24/2020,$3.97,$0.00,$3615.36,Print
5/24/2020,$4.00,$0.00,$3611.36,Print
5/24/2020,$3.97,$0.00,$3607.39,Print
5/24/2020,$2.78,$0.00,$3604.61,Print
5/24/2020,$2.74,$0.00,$3601.87,Print
5/24/2020,$2.78,$0.00,$3599.09,Print
5/24/2020,$2.76,$0.00,$3596.33,Print
5/24/2020,$3.21,$0.00,$3593.12,Print
5/24/2020,$2.74,$0.00,$3590.38,Print
5/24/2020,$4.08,$0.00,$3586.30,Print
5/24/2020,$4.32,$0.00,$3581.98,Print
5/24/2020,$4.32,$0.00,$3577.66,Print
5/24/2020,$2.74,$0.00,$3574.92,Print
5/24/2020,$3.25,$0.00,$3571.67,Print
5/24/2020,$2.78,$0.00,$3568.89,Print
5/24/2020,$2.78,$0.00,$3566.11,Print
5/24/2020,$2.76,$0.00,$3563.35,Print
5/24/2020,$2.78,$0.00,$3560.57,Print
5/24/2020,$2.78,$0.00,$3557.79,Print
5/24/2020,$2.84,$0.00,$3554.95,Print
5/24/2020,$2.74,$0.00,$3552.21,Print
5/24/2020,$5.04,$0.00,$3547.17,Print
5/24/2020,$7.64,$0.00,$3539.53,Print
5/24/2020,$2.78,$0.00,$3536.75,Print
5/24/2020,$2.74,$0.00,$3534.01,Print
5/24/2020,$4.18,$0.00,$3529.83,Print
5/24/2020,$3.31,$0.00,$3526.52,Print
5/24/2020,$2.74,$0.00,$3523.78,Print
5/24/2020,$2.84,$0.00,$3520.94,Print
5/24/2020,$4.08,$0.00,$3516.86,Print
5/24/2020,$2.74,$0.00,$3514.12,Print
5/24/2020,$2.76,$0.00,$3511.36,Print
5/24/2020,$2.93,$0.00,$3508.43,Print
5/24/2020,$2.74,$0.00,$3505.69,Print
5/24/2020,$3.21,$0.00,$3502.48,Print
5/24/2020,$2.74,$0.00,$3499.74,Print
5/24/2020,$2.76,$0.00,$3496.98,Print
5/24/2020,$3.23,$0.00,$3493.75,Print
5/24/2020,$3.23,$0.00,$3490.52,Print
5/24/2020,$2.78,$0.00,$3487.74,Print
5/24/2020,$4.08,$0.00,$3483.66,Print
5/24/2020,$3.23,$0.00,$3480.43,Print
5/24/2020,$3.39,$0.00,$3477.04,Print
5/24/2020,$3.23,$0.00,$3473.81,Print
5/24/2020,$3.31,$0.00,$3470.50,Print
5/24/2020,$3.31,$0.00,$3467.19,Print
5/24/2020,$3.97,$0.00,$3463.22,Print
5/24/2020,$3.23,$0.00,$3459.99,Print
5/24/2020,$3.31,$0.00,$3456.68,Print
5/24/2020,$3.23,$0.00,$3453.45,Print
5/24/2020,$3.25,$0.00,$3450.20,Print
5/24/2020,$3.23,$0.00,$3446.97,Print
5/24/2020,$3.97,$0.00,$3443.00,Print
5/24/2020,$9.54,$0.00,$3433.46,Print
5/24/2020,$3.25,$0.00,$3430.21,Print
5/24/2020,$4.32,$0.00,$3425.89,Print
5/24/2020,$4.00,$0.00,$3421.89,Print
5/24/2020,$3.25,$0.00,$3418.64,Print
5/24/2020,$3.21,$0.00,$3415.43,Print
5/24/2020,$3.31,$0.00,$3412.12,Print
5/24/2020,$3.31,$0.00,$3408.81,Print
5/24/2020,$3.39,$0.00,$3405.42,Print
5/24/2020,$3.25,$0.00,$3402.17,Print
5/24/2020,$3.31,$0.00,$3398.86,Print
5/24/2020,$3.52,$0.00,$3395.34,Print
5/24/2020,$3.21,$0.00,$3392.13,Print
5/24/2020,$2.78,$0.00,$3389.35,Print
5/24/2020,$2.78,$0.00,$3386.57,Print
5/24/2020,$2.78,$0.00,$3383.79,Print
5/24/2020,$2.84,$0.00,$3380.95,Print
5/24/2020,$2.78,$0.00,$3378.17,Print
5/24/2020,$3.25,$0.00,$3374.92,Print
5/24/2020,$2.74,$0.00,$3372.18,Print
5/24/2020,$2.78,$0.00,$3369.40,Print
5/24/2020,$3.31,$0.00,$3366.09,Print
5/24/2020,$3.52,$0.00,$3362.57,Print
5/24/2020,$2.78,$0.00,$3359.79,Print
5/24/2020,$3.21,$0.00,$3356.58,Print
5/24/2020,$2.78,$0.00,$3353.80,Print
5/24/2020,$2.78,$0.00,$3351.02,Print
5/24/2020,$3.21,$0.00,$3347.81,Print
5/24/2020,$3.25,$0.00,$3344.56,Print
5/24/2020,$3.52,$0.00,$3341.04,Print
5/24/2020,$2.76,$0.00,$3338.28,Print
5/24/2020,$3.25,$0.00,$3335.03,Print
5/24/2020,$2.76,$0.00,$3332.27,Print
5/24/2020,$3.25,$0.00,$3329.02,Print
5/24/2020,$2.74,$0.00,$3326.28,Print
5/24/2020,$2.74,$0.00,$3323.54,Print
5/24/2020,$2.78,$0.00,$3320.76,Print
5/24/2020,$3.25,$0.00,$3317.51,Print
5/24/2020,$3.25,$0.00,$3314.26,Print
5/24/2020,$3.25,$0.00,$3311.01,Print
5/24/2020,$3.31,$0.00,$3307.70,Print
5/24/2020,$2.84,$0.00,$3304.86,Print
5/24/2020,$3.52,$0.00,$3301.34,Print
5/24/2020,$4.18,$0.00,$3297.16,Print
5/24/2020,$3.25,$0.00,$3293.91,Print
5/24/2020,$2.74,$0.00,$3291.17,Print
5/24/2020,$3.05,$0.00,$3288.12,Print
5/24/2020,$2.78,$0.00,$3285.34,Print
5/24/2020,$2.78,$0.00,$3282.56,Print
5/24/2020,$2.78,$0.00,$3279.78,Print
5/24/2020,$2.84,$0.00,$3276.94,Print
5/24/2020,$2.78,$0.00,$3274.16,Print
5/24/2020,$2.78,$0.00,$3271.38,Print
5/24/2020,$2.76,$0.00,$3268.62,Print
5/24/2020,$3.25,$0.00,$3265.37,Print
5/24/2020,$4.32,$0.00,$3261.05,Print
5/24/2020,$3.05,$0.00,$3258.00,Print
5/24/2020,$4.00,$0.00,$3254.00,Print
5/24/2020,$3.21,$0.00,$3250.79,Print
5/24/2020,$2.78,$0.00,$3248.01,Print
5/24/2020,$3.31,$0.00,$3244.70,Print
5/24/2020,$4.00,$0.00,$3240.70,Print
5/24/2020,$3.25,$0.00,$3237.45,Print
5/24/2020,$2.74,$0.00,$3234.71,Print
5/24/2020,$4.00,$0.00,$3230.71,Print
5/24/2020,$2.76,$0.00,$3227.95,Print
5/24/2020,$3.67,$0.00,$3224.28,Print
5/24/2020,$3.31,$0.00,$3220.97,Print
5/24/2020,$2.76,$0.00,$3218.21,Print
5/24/2020,$2.78,$0.00,$3215.43,Print
5/24/2020,$2.78,$0.00,$3212.65,Print
5/24/2020,$2.78,$0.00,$3209.87,Print
5/24/2020,$2.78,$0.00,$3207.09,Print
5/24/2020,$2.84,$0.00,$3204.25,Print
5/24/2020,$2.84,$0.00,$3201.41,Print
5/24/2020,$3.31,$0.00,$3198.10,Print
5/24/2020,$2.78,$0.00,$3195.32,Print
5/24/2020,$2.84,$0.00,$3192.48,Print
5/24/2020,$2.76,$0.00,$3189.72,Print
5/24/2020,$2.84,$0.00,$3186.88,Print
5/24/2020,$2.84,$0.00,$3184.04,Print
5/24/2020,$2.84,$0.00,$3181.20,Print
5/24/2020,$2.78,$0.00,$3178.42,Print
5/24/2020,$2.78,$0.00,$3175.64,Print
5/24/2020,$2.84,$0.00,$3172.80,Print
5/24/2020,$2.84,$0.00,$3169.96,Print
5/24/2020,$2.74,$0.00,$3167.22,Print
5/24/2020,$3.52,$0.00,$3163.70,Print
5/24/2020,$2.84,$0.00,$3160.86,Print
5/24/2020,$2.78,$0.00,$3158.08,Print
5/24/2020,$2.84,$0.00,$3155.24,Print
5/24/2020,$3.21,$0.00,$3152.03,Print
5/24/2020,$2.74,$0.00,$3149.29,Print
5/24/2020,$2.84,$0.00,$3146.45,Print
5/24/2020,$2.78,$0.00,$3143.67,Print
5/24/2020,$2.84,$0.00,$3140.83,Print
5/24/2020,$2.84,$0.00,$3137.99,Print
5/24/2020,$2.78,$0.00,$3135.21,Print
5/24/2020,$2.78,$0.00,$3132.43,Print
5/24/2020,$2.76,$0.00,$3129.67,Print
5/24/2020,$2.84,$0.00,$3126.83,Print
5/24/2020,$2.76,$0.00,$3124.07,Print
5/24/2020,$2.78,$0.00,$3121.29,Print
5/24/2020,$2.76,$0.00,$3118.53,Print
5/24/2020,$2.84,$0.00,$3115.69,Print
5/24/2020,$3.25,$0.00,$3112.44,Print
5/24/2020,$2.84,$0.00,$3109.60,Print
5/24/2020,$2.78,$0.00,$3106.82,Print
5/24/2020,$2.78,$0.00,$3104.04,Print
5/24/2020,$2.74,$0.00,$3101.30,Print
5/24/2020,$2.84,$0.00,$3098.46,Print
5/24/2020,$2.84,$0.00,$3095.62,Print
5/24/2020,$2.84,$0.00,$3092.78,Print
5/24/2020,$2.84,$0.00,$3089.94,Print
5/24/2020,$2.78,$0.00,$3087.16,Print
5/24/2020,$2.93,$0.00,$3084.23,Print
5/24/2020,$2.76,$0.00,$3081.47,Print
5/24/2020,$2.78,$0.00,$3078.69,Print
5/24/2020,$2.76,$0.00,$3075.93,Print
5/24/2020,$2.76,$0.00,$3073.17,Print
5/24/2020,$2.84,$0.00,$3070.33,Print
5/24/2020,$2.74,$0.00,$3067.59,Print
5/24/2020,$2.84,$0.00,$3064.75,Print
5/24/2020,$2.84,$0.00,$3061.91,Print
5/24/2020,$2.78,$0.00,$3059.13,Print
5/24/2020,$2.76,$0.00,$3056.37,Print
5/24/2020,$2.78,$0.00,$3053.59,Print
5/24/2020,$2.84,$0.00,$3050.75,Print
5/24/2020,$2.74,$0.00,$3048.01,Print
5/24/2020,$2.76,$0.00,$3045.25,Print
5/24/2020,$2.76,$0.00,$3042.49,Print
5/24/2020,$2.84,$0.00,$3039.65,Print
5/24/2020,$2.76,$0.00,$3036.89,Print
5/24/2020,$2.93,$0.00,$3033.96,Print
5/24/2020,$2.76,$0.00,$3031.20,Print
5/24/2020,$2.78,$0.00,$3028.42,Print
5/24/2020,$2.84,$0.00,$3025.58,Print
5/24/2020,$2.84,$0.00,$3022.74,Print
5/24/2020,$3.21,$0.00,$3019.53,Print
5/24/2020,$2.84,$0.00,$3016.69,Print
5/24/2020,$2.84,$0.00,$3013.85,Print
5/24/2020,$2.84,$0.00,$3011.01,Print
5/24/2020,$2.84,$0.00,$3008.17,Print
5/24/2020,$2.78,$0.00,$3005.39,Print
5/24/2020,$2.84,$0.00,$3002.55,Print
5/24/2020,$2.76,$0.00,$2999.79,Print
5/24/2020,$3.21,$0.00,$2996.58,Print
5/24/2020,$2.84,$0.00,$2993.74,Print
5/24/2020,$3.05,$0.00,$2990.69,Print
5/24/2020,$2.78,$0.00,$2987.91,Print
5/24/2020,$3.05,$0.00,$2984.86,Print
5/24/2020,$2.76,$0.00,$2982.10,Print
5/24/2020,$2.84,$0.00,$2979.26,Print
5/24/2020,$2.78,$0.00,$2976.48,Print
5/24/2020,$2.74,$0.00,$2973.74,Print
5/24/2020,$2.84,$0.00,$2970.90,Print
5/24/2020,$2.84,$0.00,$2968.06,Print
5/24/2020,$2.78,$0.00,$2965.28,Print
5/24/2020,$3.25,$0.00,$2962.03,Print
5/24/2020,$2.76,$0.00,$2959.27,Print
5/24/2020,$2.76,$0.00,$2956.51,Print
5/24/2020,$2.78,$0.00,$2953.73,Print
5/24/2020,$2.76,$0.00,$2950.97,Print
5/24/2020,$2.76,$0.00,$2948.21,Print
5/24/2020,$2.74,$0.00,$2945.47,Print
5/24/2020,$2.84,$0.00,$2942.63,Print
5/24/2020,$2.84,$0.00,$2939.79,Print
5/24/2020,$2.74,$0.00,$2937.05,Print
5/24/2020,$3.31,$0.00,$2933.74,Print
5/24/2020,$2.78,$0.00,$2930.96,Print
5/24/2020,$3.21,$0.00,$2927.75,Print
5/24/2020,$3.21,$0.00,$2924.54,Print
5/24/2020,$2.78,$0.00,$2921.76,Print
5/24/2020,$3.52,$0.00,$2918.24,Print
5/24/2020,$3.31,$0.00,$2914.93,Print
5/24/2020,$3.25,$0.00,$2911.68,Print
5/24/2020,$3.31,$0.00,$2908.37,Print
5/24/2020,$2.74,$0.00,$2905.63,Print
5/24/2020,$3.21,$0.00,$2902.42,Print
5/24/2020,$2.84,$0.00,$2899.58,Print
5/24/2020,$3.23,$0.00,$2896.35,Print
5/24/2020,$2.84,$0.00,$2893.51,Print
5/24/2020,$2.84,$0.00,$2890.67,Print
5/24/2020,$2.74,$0.00,$2887.93,Print
5/24/2020,$2.84,$0.00,$2885.09,Print
5/24/2020,$3.39,$0.00,$2881.70,Print
5/24/2020,$2.84,$0.00,$2878.86,Print
5/24/2020,$2.84,$0.00,$2876.02,Print
5/24/2020,$2.84,$0.00,$2873.18,Print
5/24/2020,$2.84,$0.00,$2870.34,Print
5/24/2020,$3.31,$0.00,$2867.03,Print
5/24/2020,$2.74,$0.00,$2864.29,Print
5/24/2020,$2.84,$0.00,$2861.45,Print
5/24/2020,$2.84,$0.00,$2858.61,Print
5/24/2020,$3.25,$0.00,$2855.36,Print
5/24/2020,$2.84,$0.00,$2852.52,Print
5/24/2020,$2.78,$0.00,$2849.74,Print
5/24/2020,$2.76,$0.00,$2846.98,Print
5/24/2020,$3.31,$0.00,$2843.67,Print
5/24/2020,$2.84,$0.00,$2840.83,Print
5/24/2020,$2.78,$0.00,$2838.05,Print
5/24/2020,$2.78,$0.00,$2835.27,Print
5/24/2020,$2.84,$0.00,$2832.43,Print
5/24/2020,$2.84,$0.00,$2829.59,Print
5/24/2020,$2.78,$0.00,$2826.81,Print
5/24/2020,$2.84,$0.00,$2823.97,Print
5/24/2020,$2.84,$0.00,$2821.13,Print
5/24/2020,$2.84,$0.00,$2818.29,Print
5/24/2020,$2.78,$0.00,$2815.51,Print
5/24/2020,$2.84,$0.00,$2812.67,Print
5/24/2020,$2.84,$0.00,$2809.83,Print
5/24/2020,$2.74,$0.00,$2807.09,Print
5/24/2020,$2.78,$0.00,$2804.31,Print
5/24/2020,$2.78,$0.00,$2801.53,Print
5/24/2020,$2.84,$0.00,$2798.69,Print
5/24/2020,$2.78,$0.00,$2795.91,Print
5/24/2020,$2.74,$0.00,$2793.17,Print
5/24/2020,$2.84,$0.00,$2790.33,Print
5/24/2020,$2.74,$0.00,$2787.59,Print
5/24/2020,$2.74,$0.00,$2784.85,Print
5/24/2020,$2.78,$0.00,$2782.07,Print
5/24/2020,$2.78,$0.00,$2779.29,Print
5/24/2020,$2.84,$0.00,$2776.45,Print
5/24/2020,$2.76,$0.00,$2773.69,Print
5/24/2020,$2.84,$0.00,$2770.85,Print
5/24/2020,$2.74,$0.00,$2768.11,Print
5/24/2020,$2.76,$0.00,$2765.35,Print
5/24/2020,$2.84,$0.00,$2762.51,Print
5/24/2020,$2.78,$0.00,$2759.73,Print
5/24/2020,$2.78,$0.00,$2756.95,Print
5/24/2020,$2.84,$0.00,$2754.11,Print
5/24/2020,$2.84,$0.00,$2751.27,Print
5/24/2020,$3.31,$0.00,$2747.96,Print
5/24/2020,$2.84,$0.00,$2745.12,Print
5/24/2020,$2.74,$0.00,$2742.38,Print
5/24/2020,$2.84,$0.00,$2739.54,Print
5/24/2020,$2.78,$0.00,$2736.76,Print
5/24/2020,$2.78,$0.00,$2733.98,Print
5/24/2020,$2.78,$0.00,$2731.20,Print
5/24/2020,$2.78,$0.00,$2728.42,Print
5/24/2020,$2.84,$0.00,$2725.58,Print
5/24/2020,$3.25,$0.00,$2722.33,Print
5/24/2020,$2.76,$0.00,$2719.57,Print
5/24/2020,$2.78,$0.00,$2716.79,Print
5/24/2020,$2.84,$0.00,$2713.95,Print
5/24/2020,$2.84,$0.00,$2711.11,Print
5/24/2020,$2.84,$0.00,$2708.27,Print
5/24/2020,$2.74,$0.00,$2705.53,Print
5/24/2020,$2.84,$0.00,$2702.69,Print
5/24/2020,$2.93,$0.00,$2699.76,Print
5/24/2020,$2.76,$0.00,$2697.00,Print
5/24/2020,$2.84,$0.00,$2694.16,Print
5/24/2020,$2.84,$0.00,$2691.32,Print
5/24/2020,$2.84,$0.00,$2688.48,Print
5/24/2020,$2.84,$0.00,$2685.64,Print
5/24/2020,$2.78,$0.00,$2682.86,Print
5/24/2020,$3.31,$0.00,$2679.55,Print
5/24/2020,$2.84,$0.00,$2676.71,Print
5/24/2020,$3.25,$0.00,$2673.46,Print
5/24/2020,$2.84,$0.00,$2670.62,Print
5/24/2020,$2.84,$0.00,$2667.78,Print
5/24/2020,$2.74,$0.00,$2665.04,Print
5/24/2020,$2.76,$0.00,$2662.28,Print
5/24/2020,$2.84,$0.00,$2659.44,Print
5/24/2020,$2.76,$0.00,$2656.68,Print
5/24/2020,$2.84,$0.00,$2653.84,Print
5/24/2020,$2.76,$0.00,$2651.08,Print
5/24/2020,$2.76,$0.00,$2648.32,Print
5/24/2020,$2.84,$0.00,$2645.48,Print
5/24/2020,$2.84,$0.00,$2642.64,Print
5/24/2020,$2.76,$0.00,$2639.88,Print
5/24/2020,$2.84,$0.00,$2637.04,Print
5/24/2020,$2.76,$0.00,$2634.28,Print
5/24/2020,$2.84,$0.00,$2631.44,Print
5/24/2020,$2.78,$0.00,$2628.66,Print
5/24/2020,$2.78,$0.00,$2625.88,Print
5/24/2020,$2.84,$0.00,$2623.04,Print
5/24/2020,$2.76,$0.00,$2620.28,Print
5/24/2020,$2.76,$0.00,$2617.52,Print
5/24/2020,$2.84,$0.00,$2614.68,Print
5/24/2020,$2.78,$0.00,$2611.90,Print
5/24/2020,$2.84,$0.00,$2609.06,Print
5/24/2020,$2.78,$0.00,$2606.28,Print
5/24/2020,$2.74,$0.00,$2603.54,Print
5/24/2020,$4.08,$0.00,$2599.46,Print
5/24/2020,$2.74,$0.00,$2596.72,Print
5/24/2020,$2.78,$0.00,$2593.94,Print
5/24/2020,$2.93,$0.00,$2591.01,Print
5/24/2020,$2.84,$0.00,$2588.17,Print
5/24/2020,$11.30,$0.00,$2576.87,Print
5/24/2020,$2.78,$0.00,$2574.09,Print
5/24/2020,$2.84,$0.00,$2571.25,Print
5/24/2020,$3.31,$0.00,$2567.94,Print
5/24/2020,$3.21,$0.00,$2564.73,Print
5/24/2020,$3.25,$0.00,$2561.48,Print
5/24/2020,$2.78,$0.00,$2558.70,Print
5/24/2020,$2.74,$0.00,$2555.96,Print
5/24/2020,$3.23,$0.00,$2552.73,Print
5/24/2020,$3.52,$0.00,$2549.21,Print
5/24/2020,$3.21,$0.00,$2546.00,Print
5/24/2020,$2.84,$0.00,$2543.16,Print
5/24/2020,$3.25,$0.00,$2539.91,Print
5/24/2020,$2.74,$0.00,$2537.17,Print
5/24/2020,$2.84,$0.00,$2534.33,Print
5/24/2020,$2.74,$0.00,$2531.59,Print
5/24/2020,$2.84,$0.00,$2528.75,Print
5/24/2020,$2.78,$0.00,$2525.97,Print
5/24/2020,$2.78,$0.00,$2523.19,Print
5/24/2020,$2.84,$0.00,$2520.35,Print
5/24/2020,$3.52,$0.00,$2516.83,Print
5/24/2020,$2.78,$0.00,$2514.05,Print
5/24/2020,$2.76,$0.00,$2511.29,Print
5/24/2020,$2.84,$0.00,$2508.45,Print
5/24/2020,$2.78,$0.00,$2505.67,Print
5/24/2020,$3.21,$0.00,$2502.46,Print
5/24/2020,$3.31,$0.00,$2499.15,Print
5/24/2020,$2000.00,$0.00,$4499.15,Purchase
5/24/2020,$3.31,$0.00,$4495.84,Print
5/24/2020,$3.23,$0.00,$4492.61,Print
5/24/2020,$3.97,$0.00,$4488.64,Print
5/24/2020,$2.84,$0.00,$4485.80,Print
5/24/2020,$3.31,$0.00,$4482.49,Print
5/24/2020,$3.39,$0.00,$4479.10,Print
5/24/2020,$3.31,$0.00,$4475.79,Print
5/24/2020,$3.31,$0.00,$4472.48,Print
5/24/2020,$3.21,$0.00,$4469.27,Print
5/24/2020,$3.21,$0.00,$4466.06,Print
5/24/2020,$5.12,$0.00,$4460.94,Print
5/24/2020,$3.21,$0.00,$4457.73,Print
5/24/2020,$2.76,$0.00,$4454.97,Print
5/24/2020,$2.78,$0.00,$4452.19,Print
5/24/2020,$2.84,$0.00,$4449.35,Print
5/24/2020,$3.23,$0.00,$4446.12,Print
5/24/2020,$2.78,$0.00,$4443.34,Print
5/24/2020,$2.84,$0.00,$4440.50,Print
5/24/2020,$2.84,$0.00,$4437.66,Print
5/24/2020,$2.76,$0.00,$4434.90,Print
5/24/2020,$2.78,$0.00,$4432.12,Print
5/24/2020,$2.78,$0.00,$4429.34,Print
5/24/2020,$2.84,$0.00,$4426.50,Print
5/24/2020,$2.93,$0.00,$4423.57,Print
5/24/2020,$2.84,$0.00,$4420.73,Print
5/24/2020,$3.93,$0.00,$4416.80,Print
5/24/2020,$3.21,$0.00,$4413.59,Print
5/24/2020,$4.00,$0.00,$4409.59,Print
5/24/2020,$3.23,$0.00,$4406.36,Print
5/24/2020,$2.76,$0.00,$4403.60,Print
5/24/2020,$3.25,$0.00,$4400.35,Print
5/24/2020,$2.84,$0.00,$4397.51,Print
5/24/2020,$2.78,$0.00,$4394.73,Print
5/24/2020,$2.78,$0.00,$4391.95,Print
5/24/2020,$2.78,$0.00,$4389.17,Print
5/24/2020,$2.78,$0.00,$4386.39,Print
5/24/2020,$2.76,$0.00,$4383.63,Print
5/24/2020,$2.93,$0.00,$4380.70,Print
5/24/2020,$2.76,$0.00,$4377.94,Print
5/24/2020,$2.84,$0.00,$4375.10,Print
5/24/2020,$2.93,$0.00,$4372.17,Print
5/24/2020,$2.84,$0.00,$4369.33,Print
5/24/2020,$2.84,$0.00,$4366.49,Print
5/24/2020,$2.84,$0.00,$4363.65,Print
5/24/2020,$2.76,$0.00,$4360.89,Print
5/24/2020,$2.93,$0.00,$4357.96,Print
5/24/2020,$2.78,$0.00,$4355.18,Print
5/24/2020,$2.84,$0.00,$4352.34,Print
5/24/2020,$2.84,$0.00,$4349.50,Print
5/24/2020,$2.74,$0.00,$4346.76,Print
5/24/2020,$2.78,$0.00,$4343.98,Print
5/24/2020,$2.78,$0.00,$4341.20,Print
5/24/2020,$3.21,$0.00,$4337.99,Print
5/24/2020,$3.25,$0.00,$4334.74,Print
5/24/2020,$2.84,$0.00,$4331.90,Print
5/24/2020,$3.93,$0.00,$4327.97,Print
5/24/2020,$2.76,$0.00,$4325.21,Print
5/24/2020,$2.84,$0.00,$4322.37,Print
5/24/2020,$2.78,$0.00,$4319.59,Print
5/24/2020,$2.78,$0.00,$4316.81,Print
5/24/2020,$2.84,$0.00,$4313.97,Print
5/24/2020,$2.78,$0.00,$4311.19,Print
5/24/2020,$2.93,$0.00,$4308.26,Print
5/24/2020,$2.74,$0.00,$4305.52,Print
5/24/2020,$2.76,$0.00,$4302.76,Print
5/24/2020,$2.74,$0.00,$4300.02,Print
5/24/2020,$2.76,$0.00,$4297.26,Print
5/24/2020,$2.84,$0.00,$4294.42,Print
5/24/2020,$2.84,$0.00,$4291.58,Print
5/24/2020,$2.76,$0.00,$4288.82,Print
5/24/2020,$2.84,$0.00,$4285.98,Print
5/24/2020,$2.78,$0.00,$4283.20,Print
5/24/2020,$2.84,$0.00,$4280.36,Print
5/24/2020,$2.84,$0.00,$4277.52,Print
5/24/2020,$2.78,$0.00,$4274.74,Print
5/24/2020,$2.84,$0.00,$4271.90,Print
5/24/2020,$2.84,$0.00,$4269.06,Print
5/24/2020,$2.74,$0.00,$4266.32,Print
5/24/2020,$3.05,$0.00,$4263.27,Print
5/24/2020,$2.78,$0.00,$4260.49,Print
5/24/2020,$2.76,$0.00,$4257.73,Print
5/24/2020,$2.84,$0.00,$4254.89,Print
5/24/2020,$2.74,$0.00,$4252.15,Print
5/24/2020,$2.76,$0.00,$4249.39,Print
5/24/2020,$2.84,$0.00,$4246.55,Print
5/24/2020,$3.23,$0.00,$4243.32,Print
5/24/2020,$3.25,$0.00,$4240.07,Print
5/24/2020,$2.76,$0.00,$4237.31,Print
5/24/2020,$2.74,$0.00,$4234.57,Print
5/24/2020,$2.78,$0.00,$4231.79,Print
5/24/2020,$2.84,$0.00,$4228.95,Print
5/24/2020,$2.76,$0.00,$4226.19,Print
5/24/2020,$2.76,$0.00,$4223.43,Print
5/24/2020,$2.84,$0.00,$4220.59,Print
5/24/2020,$2.93,$0.00,$4217.66,Print
5/24/2020,$2.76,$0.00,$4214.90,Print
5/24/2020,$2.84,$0.00,$4212.06,Print
5/24/2020,$2.76,$0.00,$4209.30,Print
5/24/2020,$3.39,$0.00,$4205.91,Print
5/24/2020,$2.74,$0.00,$4203.17,Print
5/24/2020,$2.78,$0.00,$4200.39,Print
5/24/2020,$2.84,$0.00,$4197.55,Print
5/24/2020,$2.84,$0.00,$4194.71,Print
5/24/2020,$2.78,$0.00,$4191.93,Print
5/24/2020,$2.84,$0.00,$4189.09,Print
5/24/2020,$2.76,$0.00,$4186.33,Print
5/24/2020,$2.74,$0.00,$4183.59,Print
5/24/2020,$2.84,$0.00,$4180.75,Print
5/24/2020,$2.78,$0.00,$4177.97,Print
5/24/2020,$2.84,$0.00,$4175.13,Print
5/24/2020,$2.78,$0.00,$4172.35,Print
5/24/2020,$2.84,$0.00,$4169.51,Print
5/24/2020,$2.76,$0.00,$4166.75,Print
5/24/2020,$2.74,$0.00,$4164.01,Print
5/24/2020,$2.78,$0.00,$4161.23,Print
5/24/2020,$3.21,$0.00,$4158.02,Print
5/24/2020,$2.84,$0.00,$4155.18,Print
5/24/2020,$2.74,$0.00,$4152.44,Print
5/24/2020,$2.78,$0.00,$4149.66,Print
5/24/2020,$2.78,$0.00,$4146.88,Print
5/24/2020,$2.76,$0.00,$4144.12,Print
5/24/2020,$2.84,$0.00,$4141.28,Print
5/24/2020,$2.76,$0.00,$4138.52,Print
5/24/2020,$2.76,$0.00,$4135.76,Print
5/24/2020,$2.74,$0.00,$4133.02,Print
5/24/2020,$2.93,$0.00,$4130.09,Print
5/24/2020,$2.84,$0.00,$4127.25,Print
5/24/2020,$2.74,$0.00,$4124.51,Print
5/24/2020,$2.74,$0.00,$4121.77,Print
5/24/2020,$2.76,$0.00,$4119.01,Print
5/24/2020,$2.76,$0.00,$4116.25,Print
5/24/2020,$2.74,$0.00,$4113.51,Print
5/24/2020,$2.78,$0.00,$4110.73,Print
5/24/2020,$2.74,$0.00,$4107.99,Print
5/24/2020,$3.25,$0.00,$4104.74,Print
5/24/2020,$2.74,$0.00,$4102.00,Print
5/24/2020,$2.76,$0.00,$4099.24,Print
5/24/2020,$2.78,$0.00,$4096.46,Print
5/24/2020,$3.31,$0.00,$4093.15,Print
5/24/2020,$3.21,$0.00,$4089.94,Print
5/24/2020,$2.84,$0.00,$4087.10,Print
5/24/2020,$2.74,$0.00,$4084.36,Print
5/24/2020,$2.84,$0.00,$4081.52,Print
5/24/2020,$2.84,$0.00,$4078.68,Print
5/24/2020,$2.93,$0.00,$4075.75,Print
5/24/2020,$2.84,$0.00,$4072.91,Print
5/24/2020,$3.31,$0.00,$4069.60,Print
5/24/2020,$2.93,$0.00,$4066.67,Print
5/24/2020,$2.76,$0.00,$4063.91,Print
5/24/2020,$3.05,$0.00,$4060.86,Print
5/24/2020,$5.27,$0.00,$4055.59,Print
5/24/2020,$2.78,$0.00,$4052.81,Print
5/24/2020,$3.31,$0.00,$4049.50,Print
5/24/2020,$2.76,$0.00,$4046.74,Print
5/24/2020,$3.31,$0.00,$4043.43,Print
5/24/2020,$2.76,$0.00,$4040.67,Print
5/24/2020,$3.25,$0.00,$4037.42,Print
5/24/2020,$2.78,$0.00,$4034.64,Print
5/24/2020,$2.78,$0.00,$4031.86,Print
5/24/2020,$3.23,$0.00,$4028.63,Print
5/24/2020,$3.21,$0.00,$4025.42,Print
5/24/2020,$2.74,$0.00,$4022.68,Print
5/24/2020,$2.74,$0.00,$4019.94,Print
5/24/2020,$2.78,$0.00,$4017.16,Print
5/24/2020,$2.84,$0.00,$4014.32,Print
5/24/2020,$3.18,$0.00,$4011.14,Print
5/24/2020,$2.84,$0.00,$4008.30,Print
5/24/2020,$2.74,$0.00,$4005.56,Print
5/24/2020,$2.78,$0.00,$4002.78,Print
5/24/2020,$2.84,$0.00,$3999.94,Print
5/24/2020,$2.74,$0.00,$3997.20,Print
5/24/2020,$2.84,$0.00,$3994.36,Print
5/24/2020,$2.84,$0.00,$3991.52,Print
5/24/2020,$2.76,$0.00,$3988.76,Print
5/24/2020,$2.74,$0.00,$3986.02,Print
5/24/2020,$2.84,$0.00,$3983.18,Print
5/24/2020,$2.78,$0.00,$3980.40,Print
5/24/2020,$2.74,$0.00,$3977.66,Print
5/24/2020,$2.76,$0.00,$3974.90,Print
5/24/2020,$3.25,$0.00,$3971.65,Print
5/24/2020,$2.76,$0.00,$3968.89,Print
5/24/2020,$2.78,$0.00,$3966.11,Print
5/24/2020,$2.76,$0.00,$3963.35,Print
5/24/2020,$2.74,$0.00,$3960.61,Print
5/24/2020,$2.76,$0.00,$3957.85,Print
5/24/2020,$2.76,$0.00,$3955.09,Print
5/24/2020,$2.76,$0.00,$3952.33,Print
5/24/2020,$2.84,$0.00,$3949.49,Print
5/24/2020,$2.84,$0.00,$3946.65,Print
5/24/2020,$2.84,$0.00,$3943.81,Print
5/24/2020,$2.78,$0.00,$3941.03,Print
5/24/2020,$2.84,$0.00,$3938.19,Print
5/24/2020,$3.21,$0.00,$3934.98,Print
5/24/2020,$5.08,$0.00,$3929.90,Print
5/24/2020,$2.84,$0.00,$3927.06,Print
5/24/2020,$2.76,$0.00,$3924.30,Print
5/24/2020,$7.02,$0.00,$3917.28,Print
5/24/2020,$3.25,$0.00,$3914.03,Print
5/24/2020,$2.76,$0.00,$3911.27,Print
5/24/2020,$3.39,$0.00,$3907.88,Print
5/24/2020,$3.23,$0.00,$3904.65,Print
5/24/2020,$2.84,$0.00,$3901.81,Print
5/24/2020,$2.84,$0.00,$3898.97,Print
5/24/2020,$2.76,$0.00,$3896.21,Print
5/24/2020,$2.76,$0.00,$3893.45,Print
5/24/2020,$2.84,$0.00,$3890.61,Print
5/24/2020,$2.78,$0.00,$3887.83,Print
5/24/2020,$2.78,$0.00,$3885.05,Print
5/24/2020,$2.84,$0.00,$3882.21,Print
5/24/2020,$2.76,$0.00,$3879.45,Print
5/24/2020,$2.84,$0.00,$3876.61,Print
5/24/2020,$2.84,$0.00,$3873.77,Print
5/24/2020,$2.74,$0.00,$3871.03,Print
5/24/2020,$2.84,$0.00,$3868.19,Print
5/24/2020,$2.74,$0.00,$3865.45,Print
5/24/2020,$2.84,$0.00,$3862.61,Print
5/24/2020,$2.84,$0.00,$3859.77,Print
5/24/2020,$2.74,$0.00,$3857.03,Print
5/24/2020,$2.78,$0.00,$3854.25,Print
5/24/2020,$2.84,$0.00,$3851.41,Print
5/24/2020,$2.74,$0.00,$3848.67,Print
5/24/2020,$2.76,$0.00,$3845.91,Print
5/24/2020,$2.84,$0.00,$3843.07,Print
5/24/2020,$2.76,$0.00,$3840.31,Print
5/24/2020,$3.93,$0.00,$3836.38,Print
5/24/2020,$2.78,$0.00,$3833.60,Print
5/24/2020,$2.78,$0.00,$3830.82,Print
5/24/2020,$2.76,$0.00,$3828.06,Print
5/24/2020,$2.76,$0.00,$3825.30,Print
5/24/2020,$2.78,$0.00,$3822.52,Print
5/24/2020,$2.84,$0.00,$3819.68,Print
5/24/2020,$3.23,$0.00,$3816.45,Print
5/24/2020,$2.78,$0.00,$3813.67,Print
5/24/2020,$5.12,$0.00,$3808.55,Print
5/24/2020,$3.21,$0.00,$3805.34,Print
5/24/2020,$3.23,$0.00,$3802.11,Print
5/24/2020,$3.21,$0.00,$3798.90,Print
5/24/2020,$3.93,$0.00,$3794.97,Print
5/24/2020,$2.78,$0.00,$3792.19,Print
5/24/2020,$5.12,$0.00,$3787.07,Print
5/24/2020,$3.23,$0.00,$3783.84,Print
5/24/2020,$3.25,$0.00,$3780.59,Print
5/24/2020,$3.31,$0.00,$3777.28,Print
5/24/2020,$2.78,$0.00,$3774.50,Print
5/24/2020,$3.21,$0.00,$3771.29,Print
5/24/2020,$3.25,$0.00,$3768.04,Print
5/24/2020,$2.93,$0.00,$3765.11,Print
5/24/2020,$3.21,$0.00,$3761.90,Print
5/24/2020,$3.21,$0.00,$3758.69,Print
5/24/2020,$3.23,$0.00,$3755.46,Print
5/24/2020,$2.74,$0.00,$3752.72,Print
5/24/2020,$2.84,$0.00,$3749.88,Print
5/24/2020,$2.74,$0.00,$3747.14,Print
5/24/2020,$3.23,$0.00,$3743.91,Print
5/24/2020,$2.74,$0.00,$3741.17,Print
5/24/2020,$3.31,$0.00,$3737.86,Print
5/24/2020,$2.74,$0.00,$3735.12,Print
5/24/2020,$3.23,$0.00,$3731.89,Print
5/24/2020,$2.84,$0.00,$3729.05,Print
5/24/2020,$2.74,$0.00,$3726.31,Print
5/24/2020,$3.21,$0.00,$3723.10,Print
5/24/2020,$2.74,$0.00,$3720.36,Print
5/24/2020,$2.76,$0.00,$3717.60,Print
5/24/2020,$2.76,$0.00,$3714.84,Print
5/24/2020,$2.76,$0.00,$3712.08,Print
5/24/2020,$2.78,$0.00,$3709.30,Print
5/24/2020,$2.84,$0.00,$3706.46,Print
5/24/2020,$3.23,$0.00,$3703.23,Print
5/24/2020,$4.08,$0.00,$3699.15,Print
5/24/2020,$2.84,$0.00,$3696.31,Print
5/24/2020,$3.25,$0.00,$3693.06,Print
5/24/2020,$3.21,$0.00,$3689.85,Print
5/24/2020,$2.74,$0.00,$3687.11,Print
5/24/2020,$3.25,$0.00,$3683.86,Print
5/24/2020,$3.25,$0.00,$3680.61,Print
5/24/2020,$5.27,$0.00,$3675.34,Print
5/24/2020,$5.12,$0.00,$3670.22,Print
5/24/2020,$2.78,$0.00,$3667.44,Print
5/24/2020,$3.23,$0.00,$3664.21,Print
5/24/2020,$3.25,$0.00,$3660.96,Print
5/24/2020,$3.23,$0.00,$3657.73,Print
5/24/2020,$15.14,$0.00,$3642.59,Print
5/24/2020,$2.74,$0.00,$3639.85,Print
5/24/2020,$2.84,$0.00,$3637.01,Print
5/24/2020,$2.84,$0.00,$3634.17,Print
5/24/2020,$2.76,$0.00,$3631.41,Print
5/24/2020,$2.74,$0.00,$3628.67,Print
5/24/2020,$3.05,$0.00,$3625.62,Print
5/24/2020,$2.78,$0.00,$3622.84,Print
5/24/2020,$2.84,$0.00,$3620.00,Print
5/24/2020,$2.78,$0.00,$3617.22,Print
5/24/2020,$2.84,$0.00,$3614.38,Print
5/24/2020,$2.74,$0.00,$3611.64,Print
5/24/2020,$3.23,$0.00,$3608.41,Print
5/24/2020,$3.23,$0.00,$3605.18,Print
5/24/2020,$3.21,$0.00,$3601.97,Print
5/24/2020,$3.31,$0.00,$3598.66,Print
5/24/2020,$3.25,$0.00,$3595.41,Print
5/24/2020,$2.76,$0.00,$3592.65,Print
5/24/2020,$3.39,$0.00,$3589.26,Print
5/24/2020,$3.21,$0.00,$3586.05,Print
5/24/2020,$3.31,$0.00,$3582.74,Print
5/24/2020,$3.21,$0.00,$3579.53,Print
5/24/2020,$2.78,$0.00,$3576.75,Print
5/24/2020,$3.25,$0.00,$3573.50,Print
5/24/2020,$5.08,$0.00,$3568.42,Print
5/24/2020,$3.25,$0.00,$3565.17,Print
5/24/2020,$2.76,$0.00,$3562.41,Print
5/24/2020,$2.76,$0.00,$3559.65,Print
5/24/2020,$0.00,$2.47,$3562.12,Adjustment
5/24/2020,$0.00,$2.43,$3564.55,Adjustment
5/24/2020,$0.00,$2.43,$3566.98,Adjustment
5/24/2020,$0.00,$2.43,$3569.41,Adjustment
5/24/2020,$0.00,$2.43,$3571.84,Adjustment
5/24/2020,$0.00,$2.34,$3574.18,Adjustment
5/24/2020,$0.00,$2.34,$3576.52,Adjustment
5/24/2020,$0.00,$2.34,$3578.86,Adjustment
5/24/2020,$0.00,$2.34,$3581.20,Adjustment
5/24/2020,$0.00,$2.34,$3583.54,Adjustment
5/24/2020,$0.00,$2.34,$3585.88,Adjustment
5/24/2020,$0.00,$2.34,$3588.22,Adjustment
5/24/2020,$0.00,$2.34,$3590.56,Adjustment
5/24/2020,$0.00,$2.34,$3592.90,Adjustment
5/24/2020,$0.00,$2.32,$3595.22,Adjustment
5/24/2020,$0.00,$2.32,$3597.54,Adjustment
5/24/2020,$0.00,$2.32,$3599.86,Adjustment
5/24/2020,$0.00,$2.32,$3602.18,Adjustment
5/24/2020,$0.00,$2.32,$3604.50,Adjustment
5/24/2020,$0.00,$2.32,$3606.82,Adjustment
5/24/2020,$0.00,$2.32,$3609.14,Adjustment
5/24/2020,$0.00,$2.32,$3611.46,Adjustment
5/24/2020,$0.00,$2.32,$3613.78,Adjustment
5/24/2020,$0.00,$2.30,$3616.08,Adjustment
5/24/2020,$0.00,$2.30,$3618.38,Adjustment
5/24/2020,$0.00,$2.30,$3620.68,Adjustment
5/24/2020,$0.00,$2.30,$3622.98,Adjustment
5/24/2020,$7.02,$0.00,$3615.96,Print
5/24/2020,$2.74,$0.00,$3613.22,Print
5/24/2020,$3.23,$0.00,$3609.99,Print
5/24/2020,$2.78,$0.00,$3607.21,Print
5/24/2020,$3.25,$0.00,$3603.96,Print
5/24/2020,$3.23,$0.00,$3600.73,Print
5/24/2020,$2.78,$0.00,$3597.95,Print
5/24/2020,$2.84,$0.00,$3595.11,Print
5/24/2020,$3.21,$0.00,$3591.90,Print
5/25/2020,$2.78,$0.00,$3589.12,Print
5/25/2020,$2.78,$0.00,$3586.34,Print
5/25/2020,$2.84,$0.00,$3583.50,Print
5/25/2020,$3.23,$0.00,$3580.27,Print
5/25/2020,$3.25,$0.00,$3577.02,Print
5/25/2020,$3.23,$0.00,$3573.79,Print
5/25/2020,$2.74,$0.00,$3571.05,Print
5/25/2020,$3.23,$0.00,$3567.82,Print
5/25/2020,$2.74,$0.00,$3565.08,Print
5/25/2020,$2.93,$0.00,$3562.15,Print
5/25/2020,$2.84,$0.00,$3559.31,Print
5/25/2020,$3.23,$0.00,$3556.08,Print
5/25/2020,$3.25,$0.00,$3552.83,Print
5/25/2020,$2.76,$0.00,$3550.07,Print
5/25/2020,$3.25,$0.00,$3546.82,Print
5/25/2020,$2.84,$0.00,$3543.98,Print
5/25/2020,$2.76,$0.00,$3541.22,Print
5/25/2020,$2.74,$0.00,$3538.48,Print
5/25/2020,$0.00,$2.01,$3540.49,Adjustment
5/25/2020,$3.23,$0.00,$3537.26,Print
5/25/2020,$0.00,$1.96,$3539.22,Adjustment
5/25/2020,$0.00,$1.96,$3541.18,Adjustment
5/25/2020,$2.74,$0.00,$3538.44,Print
5/25/2020,$2.78,$0.00,$3535.66,Print
5/25/2020,$2.84,$0.00,$3532.82,Print
5/25/2020,$2.76,$0.00,$3530.06,Print
5/25/2020,$2.84,$0.00,$3527.22,Print
5/25/2020,$2.93,$0.00,$3524.29,Print
5/25/2020,$2.74,$0.00,$3521.55,Print
5/25/2020,$2.93,$0.00,$3518.62,Print
5/25/2020,$0.00,$1.87,$3520.49,Adjustment
5/25/2020,$0.00,$1.87,$3522.36,Adjustment
5/25/2020,$0.00,$1.87,$3524.23,Adjustment
5/25/2020,$0.00,$1.87,$3526.10,Adjustment
5/25/2020,$0.00,$1.87,$3527.97,Adjustment
5/25/2020,$0.00,$1.87,$3529.84,Adjustment
5/25/2020,$2.74,$0.00,$3527.10,Print
5/25/2020,$0.00,$1.85,$3528.95,Adjustment
5/25/2020,$0.00,$1.83,$3530.78,Adjustment
5/25/2020,$0.00,$1.83,$3532.61,Adjustment
5/25/2020,$0.00,$1.83,$3534.44,Adjustment
5/25/2020,$0.00,$1.83,$3536.27,Adjustment
5/25/2020,$0.00,$1.83,$3538.10,Adjustment
5/25/2020,$2.84,$0.00,$3535.26,Print
5/25/2020,$2.84,$0.00,$3532.42,Print
5/25/2020,$3.25,$0.00,$3529.17,Print
5/25/2020,$2.78,$0.00,$3526.39,Print
5/25/2020,$2.76,$0.00,$3523.63,Print
5/25/2020,$2.76,$0.00,$3520.87,Print
5/25/2020,$3.31,$0.00,$3517.56,Print
5/25/2020,$3.23,$0.00,$3514.33,Print
5/25/2020,$2.78,$0.00,$3515.83,Print
5/25/2020,$0.00,$1.28,$3517.11,Adjustment
5/25/2020,$0.00,$1.25,$3518.36,Adjustment
5/25/2020,$3.25,$0.00,$3515.11,Print
5/25/2020,$3.25,$0.00,$3511.86,Print
5/25/2020,$3.52,$0.00,$3508.34,Print
5/25/2020,$2.76,$0.00,$3505.58,Print
5/25/2020,$3.23,$0.00,$3502.35,Print
5/25/2020,$2.74,$0.00,$3499.61,Print
5/25/2020,$2.74,$0.00,$3496.87,Print
5/25/2020,$0.00,$1.24,$3498.11,Adjustment
5/25/2020,$0.00,$1.24,$3499.35,Adjustment
5/25/2020,$2.76,$0.00,$3496.59,Print
5/25/2020,$2.74,$0.00,$3493.85,Print
5/25/2020,$2.76,$0.00,$3491.09,Print
5/25/2020,$0.00,$1.24,$3492.33,Adjustment
5/25/2020,$2.76,$0.00,$3489.57,Print
5/25/2020,$0.00,$1.24,$3490.81,Adjustment
5/25/2020,$2.84,$0.00,$3487.97,Print
5/25/2020,$2.78,$0.00,$3485.19,Print
5/25/2020,$2.84,$0.00,$3482.35,Print
5/25/2020,$0.00,$1.24,$3483.59,Adjustment
5/25/2020,$2.78,$0.00,$3480.81,Print
5/25/2020,$3.31,$0.00,$3477.50,Print
5/25/2020,$2.76,$0.00,$3474.74,Print
5/25/2020,$2.74,$0.00,$3472.00,Print
5/25/2020,$3.39,$0.00,$3468.61,Print
5/25/2020,$2.76,$0.00,$3465.85,Print
5/25/2020,$3.21,$0.00,$3462.64,Print
5/25/2020,$3.23,$0.00,$3459.41,Print
5/25/2020,$2.74,$0.00,$3456.67,Print
5/25/2020,$2.76,$0.00,$3453.91,Print
5/25/2020,$3.21,$0.00,$3450.70,Print
5/25/2020,$2.74,$0.00,$3447.96,Print
5/25/2020,$2.78,$0.00,$3445.18,Print
5/25/2020,$3.25,$0.00,$3441.93,Print
5/25/2020,$3.25,$0.00,$3438.68,Print
5/25/2020,$3.25,$0.00,$3435.43,Print
5/25/2020,$3.31,$0.00,$3432.12,Print
5/25/2020,$3.31,$0.00,$3428.81,Print
5/25/2020,$2.84,$0.00,$3425.97,Print
5/25/2020,$2.93,$0.00,$3423.04,Print
5/25/2020,$2.84,$0.00,$3420.20,Print
5/25/2020,$2.76,$0.00,$3417.44,Print
5/25/2020,$2.74,$0.00,$3414.70,Print
5/25/2020,$3.23,$0.00,$3411.47,Print
5/25/2020,$3.39,$0.00,$3408.08,Print
5/25/2020,$3.31,$0.00,$3404.77,Print
5/25/2020,$2.78,$0.00,$3401.99,Print
5/25/2020,$3.23,$0.00,$3398.76,Print
5/25/2020,$2.78,$0.00,$3395.98,Print
5/25/2020,$3.31,$0.00,$3392.67,Print
5/25/2020,$2.76,$0.00,$3389.91,Print
5/25/2020,$2.78,$0.00,$3387.13,Print
5/25/2020,$3.31,$0.00,$3383.82,Print
5/25/2020,$3.25,$0.00,$3380.57,Print
5/25/2020,$2.78,$0.00,$3377.79,Print
5/25/2020,$3.31,$0.00,$3374.48,Print
5/25/2020,$3.39,$0.00,$3371.09,Print
5/25/2020,$3.31,$0.00,$3367.78,Print
5/25/2020,$2.84,$0.00,$3364.94,Print
5/25/2020,$2.74,$0.00,$3362.20,Print
5/25/2020,$3.31,$0.00,$3358.89,Print
5/25/2020,$2.76,$0.00,$3356.13,Print
5/25/2020,$2.74,$0.00,$3353.39,Print
5/25/2020,$2.78,$0.00,$3350.61,Print
5/25/2020,$2.84,$0.00,$3347.77,Print
5/25/2020,$2.78,$0.00,$3344.99,Print
5/25/2020,$3.25,$0.00,$3341.74,Print
5/25/2020,$2.78,$0.00,$3338.96,Print
5/25/2020,$2.76,$0.00,$3336.20,Print
5/25/2020,$2.78,$0.00,$3333.42,Print
5/25/2020,$2.84,$0.00,$3330.58,Print
5/25/2020,$2.78,$0.00,$3327.80,Print
5/25/2020,$2.78,$0.00,$3325.02,Print
5/25/2020,$2.84,$0.00,$3322.18,Print
5/25/2020,$2.74,$0.00,$3319.44,Print
5/25/2020,$2.78,$0.00,$3316.66,Print
5/25/2020,$3.31,$0.00,$3313.35,Print
5/25/2020,$4.00,$0.00,$3309.35,Print
5/25/2020,$2.74,$0.00,$3306.61,Print
5/25/2020,$2.78,$0.00,$3303.83,Print
5/25/2020,$2.84,$0.00,$3300.99,Print
5/25/2020,$2.78,$0.00,$3298.21,Print
5/25/2020,$3.31,$0.00,$3294.90,Print
5/25/2020,$3.21,$0.00,$3291.69,Print
5/25/2020,$3.25,$0.00,$3288.44,Print
5/25/2020,$3.25,$0.00,$3285.19,Print
5/25/2020,$2.78,$0.00,$3282.41,Print
5/25/2020,$2.84,$0.00,$3279.57,Print
5/25/2020,$2.84,$0.00,$3276.73,Print
5/25/2020,$2.78,$0.00,$3273.95,Print
5/25/2020,$7.56,$0.00,$3266.39,Print
5/25/2020,$2.76,$0.00,$3263.63,Print
5/25/2020,$2.84,$0.00,$3260.79,Print
5/25/2020,$2.76,$0.00,$3258.03,Print
5/25/2020,$2.74,$0.00,$3255.29,Print
5/25/2020,$2.76,$0.00,$3252.53,Print
5/25/2020,$2.84,$0.00,$3249.69,Print
5/25/2020,$2.84,$0.00,$3246.85,Print
5/25/2020,$2.84,$0.00,$3244.01,Print
5/25/2020,$3.23,$0.00,$3240.78,Print
5/25/2020,$2.78,$0.00,$3238.00,Print
5/25/2020,$3.21,$0.00,$3234.79,Print
5/25/2020,$2.78,$0.00,$3232.01,Print
5/25/2020,$2.84,$0.00,$3229.17,Print
5/25/2020,$2.84,$0.00,$3226.33,Print
5/25/2020,$2.76,$0.00,$3223.57,Print
5/25/2020,$2.78,$0.00,$3220.79,Print
5/25/2020,$2.76,$0.00,$3218.03,Print
5/25/2020,$2.74,$0.00,$3215.29,Print
5/25/2020,$3.21,$0.00,$3212.08,Print
5/25/2020,$2.78,$0.00,$3209.30,Print
5/25/2020,$3.23,$0.00,$3206.07,Print
5/25/2020,$2.84,$0.00,$3203.23,Print
5/25/2020,$2.93,$0.00,$3200.30,Print
5/25/2020,$3.23,$0.00,$3197.07,Print
5/25/2020,$2.74,$0.00,$3194.33,Print
5/25/2020,$2.78,$0.00,$3191.55,Print
5/25/2020,$2.78,$0.00,$3188.77,Print
5/25/2020,$2.84,$0.00,$3185.93,Print
5/25/2020,$3.31,$0.00,$3182.62,Print
5/25/2020,$3.25,$0.00,$3179.37,Print
5/25/2020,$3.31,$0.00,$3176.06,Print
5/25/2020,$2.74,$0.00,$3173.32,Print
5/25/2020,$2.78,$0.00,$3170.54,Print
5/25/2020,$3.23,$0.00,$3167.31,Print
5/25/2020,$2.76,$0.00,$3164.55,Print
5/25/2020,$3.25,$0.00,$3161.30,Print
5/25/2020,$2.74,$0.00,$3158.56,Print
5/25/2020,$3.39,$0.00,$3155.17,Print
5/25/2020,$2.76,$0.00,$3152.41,Print
5/25/2020,$4.00,$0.00,$3148.41,Print
5/25/2020,$3.05,$0.00,$3145.36,Print
5/25/2020,$3.31,$0.00,$3142.05,Print
5/25/2020,$4.00,$0.00,$3138.05,Print
5/25/2020,$3.31,$0.00,$3134.74,Print
5/25/2020,$8.59,$0.00,$3126.15,Print
5/25/2020,$2.74,$0.00,$3123.41,Print
5/25/2020,$2.76,$0.00,$3120.65,Print
5/25/2020,$2.76,$0.00,$3117.89,Print
5/25/2020,$3.21,$0.00,$3114.68,Print
5/25/2020,$3.23,$0.00,$3111.45,Print
5/25/2020,$3.21,$0.00,$3108.24,Print
5/25/2020,$2.74,$0.00,$3105.50,Print
5/25/2020,$3.21,$0.00,$3102.29,Print
5/25/2020,$2.84,$0.00,$3099.45,Print
5/25/2020,$8.42,$0.00,$3091.03,Print
5/25/2020,$3.23,$0.00,$3087.80,Print
5/25/2020,$2.76,$0.00,$3085.04,Print
5/25/2020,$4.00,$0.00,$3081.04,Print
5/25/2020,$3.23,$0.00,$3077.81,Print
5/25/2020,$2.76,$0.00,$3075.05,Print
5/25/2020,$3.31,$0.00,$3071.74,Print
5/25/2020,$3.31,$0.00,$3068.43,Print
5/25/2020,$3.21,$0.00,$3065.22,Print
5/25/2020,$2.74,$0.00,$3062.48,Print
5/25/2020,$3.31,$0.00,$3059.17,Print
5/25/2020,$3.39,$0.00,$3055.78,Print
5/25/2020,$2.76,$0.00,$3053.02,Print
5/25/2020,$2.93,$0.00,$3050.09,Print
5/25/2020,$3.25,$0.00,$3046.84,Print
5/25/2020,$2.74,$0.00,$3044.10,Print
5/25/2020,$3.31,$0.00,$3040.79,Print
5/25/2020,$3.67,$0.00,$3037.12,Print
5/25/2020,$3.05,$0.00,$3034.07,Print
5/25/2020,$3.23,$0.00,$3030.84,Print
5/25/2020,$3.25,$0.00,$3027.59,Print
5/25/2020,$3.23,$0.00,$3024.36,Print
5/25/2020,$3.31,$0.00,$3021.05,Print
5/25/2020,$2.74,$0.00,$3018.31,Print
5/25/2020,$3.93,$0.00,$3014.38,Print
5/25/2020,$2.84,$0.00,$3011.54,Print
5/25/2020,$2.74,$0.00,$3008.80,Print
5/25/2020,$2.74,$0.00,$3006.06,Print
5/25/2020,$2.78,$0.00,$3003.28,Print
5/25/2020,$3.21,$0.00,$3000.07,Print
5/25/2020,$2.78,$0.00,$2997.29,Print
5/25/2020,$2.76,$0.00,$2994.53,Print
5/25/2020,$2.84,$0.00,$2991.69,Print
5/25/2020,$2.76,$0.00,$2988.93,Print
5/25/2020,$3.31,$0.00,$2985.62,Print
5/25/2020,$3.21,$0.00,$2982.41,Print
5/25/2020,$3.25,$0.00,$2979.16,Print
5/25/2020,$3.52,$0.00,$2975.64,Print
5/25/2020,$2.76,$0.00,$2972.88,Print
5/25/2020,$3.25,$0.00,$2969.63,Print
5/25/2020,$3.31,$0.00,$2966.32,Print
5/25/2020,$3.31,$0.00,$2963.01,Print
5/25/2020,$3.25,$0.00,$2959.76,Print
5/25/2020,$3.31,$0.00,$2956.45,Print
5/25/2020,$4.32,$0.00,$2952.13,Print
5/25/2020,$3.21,$0.00,$2948.92,Print
5/25/2020,$2.84,$0.00,$2946.08,Print
5/25/2020,$3.23,$0.00,$2942.85,Print
5/25/2020,$3.23,$0.00,$2939.62,Print
5/25/2020,$3.25,$0.00,$2936.37,Print
5/25/2020,$2.84,$0.00,$2933.53,Print
5/25/2020,$3.25,$0.00,$2930.28,Print
5/25/2020,$3.21,$0.00,$2927.07,Print
5/25/2020,$3.23,$0.00,$2923.84,Print
5/25/2020,$3.25,$0.00,$2920.59,Print
5/25/2020,$2.74,$0.00,$2917.85,Print
5/25/2020,$3.21,$0.00,$2914.64,Print
5/25/2020,$4.00,$0.00,$2910.64,Print
5/25/2020,$2.84,$0.00,$2907.80,Print
5/25/2020,$2.76,$0.00,$2905.04,Print
5/25/2020,$2.93,$0.00,$2902.11,Print
5/25/2020,$2.76,$0.00,$2899.35,Print
5/25/2020,$2.74,$0.00,$2896.61,Print
5/25/2020,$3.93,$0.00,$2892.68,Print
5/25/2020,$3.93,$0.00,$2888.75,Print
5/25/2020,$3.97,$0.00,$2884.78,Print
5/25/2020,$2.78,$0.00,$2882.00,Print
5/25/2020,$3.21,$0.00,$2878.79,Print
5/25/2020,$3.97,$0.00,$2874.82,Print
5/25/2020,$2.84,$0.00,$2871.98,Print
5/25/2020,$3.23,$0.00,$2868.75,Print
5/25/2020,$3.31,$0.00,$2865.44,Print
5/25/2020,$3.23,$0.00,$2862.21,Print
5/25/2020,$2.76,$0.00,$2859.45,Print
5/25/2020,$2.76,$0.00,$2856.69,Print
5/25/2020,$3.23,$0.00,$2853.46,Print
5/25/2020,$3.21,$0.00,$2850.25,Print
5/25/2020,$3.39,$0.00,$2846.86,Print
5/25/2020,$2.76,$0.00,$2844.10,Print
5/25/2020,$2.84,$0.00,$2841.26,Print
5/25/2020,$3.25,$0.00,$2838.01,Print
5/25/2020,$2.93,$0.00,$2835.08,Print
5/25/2020,$3.23,$0.00,$2831.85,Print
5/25/2020,$3.31,$0.00,$2828.54,Print
5/25/2020,$3.93,$0.00,$2824.61,Print
5/25/2020,$4.08,$0.00,$2820.53,Print
5/25/2020,$2.76,$0.00,$2817.77,Print
5/25/2020,$3.21,$0.00,$2814.56,Print
5/25/2020,$4.00,$0.00,$2810.56,Print
5/25/2020,$2.78,$0.00,$2807.78,Print
5/25/2020,$3.25,$0.00,$2804.53,Print
5/25/2020,$2.84,$0.00,$2801.69,Print
5/25/2020,$5.08,$0.00,$2796.61,Print
5/25/2020,$2.84,$0.00,$2793.77,Print
5/25/2020,$4.00,$0.00,$2789.77,Print
5/25/2020,$2.84,$0.00,$2786.93,Print
5/25/2020,$4.08,$0.00,$2782.85,Print
5/25/2020,$3.31,$0.00,$2779.54,Print
5/25/2020,$2.93,$0.00,$2776.61,Print
5/25/2020,$3.21,$0.00,$2773.40,Print
5/25/2020,$2.78,$0.00,$2770.62,Print
5/25/2020,$3.25,$0.00,$2767.37,Print
5/25/2020,$2.84,$0.00,$2764.53,Print
5/25/2020,$2.74,$0.00,$2761.79,Print
5/25/2020,$5.27,$0.00,$2756.52,Print
5/25/2020,$3.25,$0.00,$2753.27,Print
5/25/2020,$3.52,$0.00,$2749.75,Print
5/25/2020,$3.52,$0.00,$2746.23,Print
5/25/2020,$2.78,$0.00,$2743.45,Print
5/25/2020,$3.52,$0.00,$2739.93,Print
5/25/2020,$2.78,$0.00,$2737.15,Print
5/25/2020,$3.25,$0.00,$2733.90,Print
5/25/2020,$3.31,$0.00,$2730.59,Print
5/25/2020,$2.84,$0.00,$2727.75,Print
5/25/2020,$5.08,$0.00,$2722.67,Print
5/25/2020,$3.39,$0.00,$2719.28,Print
5/25/2020,$2.84,$0.00,$2716.44,Print
5/25/2020,$2.76,$0.00,$2713.68,Print
5/25/2020,$3.31,$0.00,$2710.37,Print
5/25/2020,$5.04,$0.00,$2705.33,Print
5/25/2020,$2.76,$0.00,$2702.57,Print
5/25/2020,$2.93,$0.00,$2699.64,Print
5/25/2020,$3.25,$0.00,$2696.39,Print
5/25/2020,$3.05,$0.00,$2693.34,Print
5/25/2020,$2.76,$0.00,$2690.58,Print
5/25/2020,$3.21,$0.00,$2687.37,Print
5/25/2020,$2.84,$0.00,$2684.53,Print
5/25/2020,$2.78,$0.00,$2681.75,Print
5/25/2020,$2.74,$0.00,$2679.01,Print
5/25/2020,$2.74,$0.00,$2676.27,Print
5/25/2020,$2.78,$0.00,$2673.49,Print
5/25/2020,$2.76,$0.00,$2670.73,Print
5/25/2020,$2.78,$0.00,$2667.95,Print
5/25/2020,$2.78,$0.00,$2665.17,Print
5/25/2020,$2.93,$0.00,$2662.24,Print
5/25/2020,$2.78,$0.00,$2659.46,Print
5/25/2020,$75.86,$0.00,$2583.60,Print
5/25/2020,$2.84,$0.00,$2580.76,Print
5/25/2020,$2.74,$0.00,$2578.02,Print
5/25/2020,$2.74,$0.00,$2575.28,Print
5/25/2020,$3.25,$0.00,$2572.03,Print
5/25/2020,$3.05,$0.00,$2568.98,Print
5/25/2020,$2.78,$0.00,$2566.20,Print
5/25/2020,$3.31,$0.00,$2562.89,Print
5/25/2020,$5.27,$0.00,$2557.62,Print
5/25/2020,$3.21,$0.00,$2554.41,Print
5/25/2020,$2.78,$0.00,$2551.63,Print
5/25/2020,$2.78,$0.00,$2548.85,Print
5/25/2020,$2.78,$0.00,$2546.07,Print
5/25/2020,$3.25,$0.00,$2542.82,Print
5/25/2020,$2.74,$0.00,$2540.08,Print
5/25/2020,$4.08,$0.00,$2536.00,Print
5/25/2020,$2.78,$0.00,$2533.22,Print
5/25/2020,$2.84,$0.00,$2530.38,Print
5/25/2020,$2.78,$0.00,$2527.60,Print
5/25/2020,$2.84,$0.00,$2524.76,Print
5/25/2020,$2.78,$0.00,$2521.98,Print
5/25/2020,$2.74,$0.00,$2519.24,Print
5/25/2020,$2.74,$0.00,$2516.50,Print
5/25/2020,$8.76,$0.00,$2507.74,Print
5/25/2020,$5.12,$0.00,$2502.62,Print
5/25/2020,$2.78,$0.00,$2499.84,Print
5/25/2020,$2000.00,$0.00,$4499.84,Purchase
5/25/2020,$2.84,$0.00,$4497.00,Print
5/25/2020,$3.39,$0.00,$4493.61,Print
5/25/2020,$2.84,$0.00,$4490.77,Print
5/25/2020,$3.31,$0.00,$4487.46,Print
5/25/2020,$3.25,$0.00,$4484.21,Print
5/25/2020,$2.84,$0.00,$4481.37,Print
5/25/2020,$3.25,$0.00,$4478.12,Print
5/25/2020,$2.84,$0.00,$4475.28,Print
5/25/2020,$2.84,$0.00,$4472.44,Print
5/25/2020,$2.84,$0.00,$4469.60,Print
5/25/2020,$3.31,$0.00,$4466.29,Print
5/25/2020,$3.25,$0.00,$4463.04,Print
5/25/2020,$2.74,$0.00,$4460.30,Print
5/25/2020,$2.78,$0.00,$4457.52,Print
5/25/2020,$3.25,$0.00,$4454.27,Print
5/25/2020,$3.23,$0.00,$4451.04,Print
5/25/2020,$2.78,$0.00,$4448.26,Print
5/25/2020,$7.56,$0.00,$4440.70,Print
5/25/2020,$10.64,$0.00,$4430.06,Print
5/25/2020,$3.31,$0.00,$4426.75,Print
5/25/2020,$3.25,$0.00,$4423.50,Print
5/25/2020,$3.21,$0.00,$4420.29,Print
5/25/2020,$3.25,$0.00,$4417.04,Print
5/25/2020,$2.74,$0.00,$4414.30,Print
5/25/2020,$3.25,$0.00,$4411.05,Print
5/25/2020,$3.25,$0.00,$4407.80,Print
5/25/2020,$3.25,$0.00,$4404.55,Print
5/25/2020,$5.04,$0.00,$4399.51,Print
5/25/2020,$9.74,$0.00,$4389.77,Print
5/25/2020,$3.31,$0.00,$4386.46,Print
5/25/2020,$8.54,$0.00,$4377.92,Print
5/25/2020,$3.25,$0.00,$4374.67,Print
5/25/2020,$3.21,$0.00,$4371.46,Print
5/25/2020,$2.84,$0.00,$4368.62,Print
5/25/2020,$2.84,$0.00,$4365.78,Print
5/25/2020,$3.25,$0.00,$4362.53,Print
5/25/2020,$3.25,$0.00,$4359.28,Print
5/25/2020,$4.32,$0.00,$4354.96,Print
5/25/2020,$3.31,$0.00,$4351.65,Print
5/25/2020,$5.12,$0.00,$4346.53,Print
5/25/2020,$0.00,$1.24,$4347.77,Adjustment
5/25/2020,$0.00,$1.24,$4349.01,Adjustment
5/25/2020,$0.00,$1.24,$4350.25,Adjustment
5/25/2020,$0.00,$1.24,$4351.49,Adjustment
5/25/2020,$0.00,$1.24,$4352.73,Adjustment
5/25/2020,$0.00,$1.22,$4353.95,Adjustment
5/25/2020,$0.00,$1.22,$4355.17,Adjustment
5/25/2020,$0.00,$1.21,$4356.38,Adjustment
5/25/2020,$0.00,$1.22,$4357.60,Adjustment
5/25/2020,$0.00,$1.22,$4358.82,Adjustment
5/25/2020,$0.00,$1.22,$4360.04,Adjustment
5/25/2020,$0.00,$1.21,$4361.25,Adjustment
5/25/2020,$0.00,$1.22,$4362.47,Adjustment
5/25/2020,$0.00,$1.21,$4363.68,Adjustment
5/25/2020,$0.00,$1.22,$4364.90,Adjustment
5/25/2020,$0.00,$1.22,$4366.12,Adjustment
5/25/2020,$0.00,$1.22,$4367.34,Adjustment
5/25/2020,$0.00,$1.22,$4368.56,Adjustment
5/25/2020,$3.25,$0.00,$4365.31,Print
5/25/2020,$0.00,$1.19,$4366.50,Adjustment
5/25/2020,$0.00,$1.19,$4367.69,Adjustment
5/25/2020,$3.31,$0.00,$4364.38,Print
5/25/2020,$2.84,$0.00,$4361.54,Print
5/25/2020,$2.76,$0.00,$4358.78,Print
5/25/2020,$0.00,$1.19,$4359.97,Adjustment
5/25/2020,$0.00,$1.19,$4361.16,Adjustment
5/25/2020,$3.05,$0.00,$4358.11,Print
5/25/2020,$2.78,$0.00,$4355.33,Print
5/25/2020,$0.00,$1.19,$4356.52,Adjustment
5/25/2020,$0.00,$1.19,$4357.71,Adjustment
5/25/2020,$0.00,$1.19,$4358.90,Adjustment
5/25/2020,$2.78,$0.00,$4356.12,Print
5/25/2020,$0.00,$1.19,$4357.31,Adjustment
5/25/2020,$0.00,$1.19,$4358.50,Adjustment
5/25/2020,$2.84,$0.00,$4355.66,Print
5/25/2020,$2.84,$0.00,$4352.82,Print
5/25/2020,$2.76,$0.00,$4350.06,Print
5/25/2020,$2.84,$0.00,$4347.22,Print
5/25/2020,$2.74,$0.00,$4344.48,Print
5/25/2020,$2.84,$0.00,$4341.64,Print
5/25/2020,$2.84,$0.00,$4338.80,Print
5/25/2020,$0.00,$1.19,$4339.99,Adjustment
5/25/2020,$2.78,$0.00,$4337.21,Print
5/25/2020,$2.84,$0.00,$4334.37,Print
5/25/2020,$2.84,$0.00,$4331.53,Print
5/25/2020,$0.00,$1.19,$4332.72,Adjustment
5/25/2020,$2.76,$0.00,$4329.96,Print
5/25/2020,$0.00,$1.19,$4331.15,Adjustment
5/25/2020,$2.84,$0.00,$4328.31,Print
5/25/2020,$2.78,$0.00,$4325.53,Print
5/25/2020,$2.76,$0.00,$4322.77,Print
5/25/2020,$2.84,$0.00,$4319.93,Print
5/25/2020,$2.78,$0.00,$4317.15,Print
5/25/2020,$0.00,$1.19,$4318.34,Adjustment
5/25/2020,$2.84,$0.00,$4315.50,Print
5/25/2020,$0.00,$1.19,$4316.69,Adjustment
5/25/2020,$2.78,$0.00,$4313.91,Print
5/25/2020,$0.00,$1.19,$4315.10,Adjustment
5/25/2020,$0.00,$1.19,$4316.29,Adjustment
5/25/2020,$2.84,$0.00,$4313.45,Print
5/25/2020,$2.84,$0.00,$4310.61,Print
5/25/2020,$2.78,$0.00,$4307.83,Print
5/25/2020,$2.84,$0.00,$4304.99,Print
5/25/2020,$3.31,$0.00,$4301.68,Print
5/25/2020,$3.31,$0.00,$4298.37,Print
5/25/2020,$3.25,$0.00,$4295.12,Print
5/25/2020,$0.00,$1.12,$4296.24,Adjustment
5/25/2020,$3.31,$0.00,$4292.93,Print
5/25/2020,$3.21,$0.00,$4289.72,Print
5/25/2020,$0.00,$1.12,$4290.84,Adjustment
5/25/2020,$0.00,$1.12,$4291.96,Adjustment
5/25/2020,$0.00,$1.12,$4293.08,Adjustment
5/25/2020,$3.31,$0.00,$4289.77,Print
5/25/2020,$0.00,$1.12,$4290.89,Adjustment
5/25/2020,$0.00,$1.12,$4292.01,Adjustment
5/25/2020,$0.00,$1.12,$4293.13,Adjustment
5/25/2020,$3.39,$0.00,$4289.74,Print
5/25/2020,$3.21,$0.00,$4286.53,Print
5/25/2020,$0.00,$1.12,$4287.65,Adjustment
5/25/2020,$2.84,$0.00,$4284.81,Print
5/25/2020,$3.25,$0.00,$4281.56,Print
5/25/2020,$0.00,$1.12,$4282.68,Adjustment
5/25/2020,$0.00,$1.11,$4283.79,Adjustment
5/25/2020,$2.84,$0.00,$4280.95,Print
5/25/2020,$0.00,$1.11,$4282.06,Adjustment
5/25/2020,$3.23,$0.00,$4278.83,Print
5/25/2020,$3.21,$0.00,$4275.62,Print
5/25/2020,$3.31,$0.00,$4272.31,Print
5/25/2020,$3.21,$0.00,$4269.10,Print
5/25/2020,$2.74,$0.00,$4266.36,Print
5/25/2020,$3.25,$0.00,$4263.11,Print
5/25/2020,$3.23,$0.00,$4259.88,Print
5/25/2020,$3.31,$0.00,$4256.57,Print
5/25/2020,$2.74,$0.00,$4253.83,Print
5/25/2020,$4.08,$0.00,$4249.75,Print
5/25/2020,$0.00,$1.11,$4250.86,Adjustment
5/25/2020,$2.74,$0.00,$4248.12,Print
5/25/2020,$2.76,$0.00,$4245.36,Print
5/25/2020,$2.76,$0.00,$4242.60,Print
5/25/2020,$0.00,$1.11,$4243.71,Adjustment
5/25/2020,$3.25,$0.00,$4240.46,Print
5/25/2020,$2.76,$0.00,$4237.70,Print
5/25/2020,$2.76,$0.00,$4234.94,Print
5/25/2020,$2.84,$0.00,$4232.10,Print
5/25/2020,$2.84,$0.00,$4229.26,Print
5/25/2020,$2.84,$0.00,$4226.42,Print
5/25/2020,$0.00,$1.11,$4227.53,Adjustment
5/25/2020,$2.76,$0.00,$4224.77,Print
5/25/2020,$3.52,$0.00,$4221.25,Print
5/25/2020,$3.23,$0.00,$4218.02,Print
5/25/2020,$2.78,$0.00,$4215.24,Print
5/25/2020,$2.76,$0.00,$4212.48,Print
5/25/2020,$3.31,$0.00,$4209.17,Print
5/25/2020,$2.76,$0.00,$4206.41,Print
5/25/2020,$3.23,$0.00,$4203.18,Print
5/25/2020,$2.78,$0.00,$4200.40,Print
5/25/2020,$3.31,$0.00,$4197.09,Print
5/25/2020,$2.78,$0.00,$4194.31,Print
5/25/2020,$3.31,$0.00,$4191.00,Print
5/25/2020,$3.31,$0.00,$4187.69,Print
5/25/2020,$3.25,$0.00,$4184.44,Print
5/25/2020,$2.76,$0.00,$4181.68,Print
5/25/2020,$3.25,$0.00,$4178.43,Print
5/25/2020,$3.31,$0.00,$4175.12,Print
5/25/2020,$2.78,$0.00,$4172.34,Print
5/25/2020,$2.84,$0.00,$4169.50,Print
5/25/2020,$2.78,$0.00,$4166.72,Print
5/25/2020,$2.74,$0.00,$4163.98,Print
5/25/2020,$2.76,$0.00,$4161.22,Print
5/25/2020,$3.23,$0.00,$4157.99,Print
5/25/2020,$3.31,$0.00,$4154.68,Print
5/25/2020,$3.31,$0.00,$4151.37,Print
5/25/2020,$3.21,$0.00,$4148.16,Print
5/25/2020,$3.21,$0.00,$4144.95,Print
5/25/2020,$3.23,$0.00,$4141.72,Print
5/25/2020,$1.11,$0.00,$4140.61,Adjustment
5/25/2020,$2.84,$0.00,$4137.77,Print
5/25/2020,$2.93,$0.00,$4134.84,Print
5/25/2020,$2.84,$0.00,$4132.00,Print
5/25/2020,$2.84,$0.00,$4129.16,Print
5/25/2020,$2.74,$0.00,$4126.42,Print
5/25/2020,$2.76,$0.00,$4123.66,Print
5/25/2020,$1.11,$0.00,$4122.55,Adjustment
5/25/2020,$2.84,$0.00,$4119.71,Print
5/25/2020,$2.74,$0.00,$4116.97,Print
5/25/2020,$2.84,$0.00,$4114.13,Print
5/25/2020,$2.84,$0.00,$4111.29,Print
5/25/2020,$2.84,$0.00,$4108.45,Print
5/25/2020,$1.11,$0.00,$4107.34,Adjustment
5/25/2020,$1.11,$0.00,$4106.23,Adjustment
5/25/2020,$2.84,$0.00,$4103.39,Print
5/25/2020,$2.78,$0.00,$4100.61,Print
5/25/2020,$2.78,$0.00,$4097.83,Print
5/25/2020,$2.78,$0.00,$4095.05,Print
5/26/2020,$2.84,$0.00,$4092.21,Print
5/26/2020,$3.93,$0.00,$4088.28,Print
5/26/2020,$2.84,$0.00,$4085.44,Print
5/26/2020,$2.84,$0.00,$4082.60,Print
5/26/2020,$2.74,$0.00,$4079.86,Print
5/26/2020,$2.93,$0.00,$4076.93,Print
5/26/2020,$2.93,$0.00,$4074.00,Print
5/26/2020,$3.31,$0.00,$4070.69,Print
5/26/2020,$2.78,$0.00,$4067.91,Print
5/26/2020,$1.11,$0.00,$4066.80,Adjustment
5/26/2020,$2.78,$0.00,$4064.02,Print
5/26/2020,$2.84,$0.00,$4061.18,Print
5/26/2020,$3.05,$0.00,$4058.13,Print
5/26/2020,$2.84,$0.00,$4055.29,Print
5/26/2020,$2.84,$0.00,$4052.45,Print
5/26/2020,$3.31,$0.00,$4049.14,Print
5/26/2020,$1.12,$0.00,$4048.02,Adjustment
5/26/2020,$2.76,$0.00,$4045.26,Print
5/26/2020,$2.78,$0.00,$4042.48,Print
5/26/2020,$2.74,$0.00,$4039.74,Print
5/26/2020,$2.84,$0.00,$4036.90,Print
5/26/2020,$2.76,$0.00,$4034.14,Print
5/26/2020,$2.78,$0.00,$4031.36,Print
5/26/2020,$2.84,$0.00,$4028.52,Print
5/26/2020,$3.25,$0.00,$4025.27,Print
5/26/2020,$3.25,$0.00,$4022.02,Print
5/26/2020,$3.21,$0.00,$4018.81,Print
5/26/2020,$1.12,$0.00,$4017.69,Adjustment
5/26/2020,$3.21,$0.00,$4014.48,Print
5/26/2020,$2.93,$0.00,$4011.55,Print
5/26/2020,$2.84,$0.00,$4008.71,Print
5/26/2020,$2.84,$0.00,$4005.87,Print
5/26/2020,$1.12,$0.00,$4004.75,Adjustment
5/26/2020,$3.31,$0.00,$4001.44,Print
5/26/2020,$3.21,$0.00,$3998.23,Print
5/26/2020,$2.93,$0.00,$3995.30,Print
5/26/2020,$2.84,$0.00,$3992.46,Print
5/26/2020,$3.21,$0.00,$3989.25,Print
5/26/2020,$2.78,$0.00,$3986.47,Print
5/26/2020,$3.25,$0.00,$3983.22,Print
5/26/2020,$2.78,$0.00,$3980.44,Print
5/26/2020,$2.78,$0.00,$3977.66,Print
5/26/2020,$2.76,$0.00,$3974.90,Print
5/26/2020,$2.78,$0.00,$3972.12,Print
5/26/2020,$2.74,$0.00,$3969.38,Print
5/26/2020,$2.84,$0.00,$3966.54,Print
5/26/2020,$3.05,$0.00,$3963.49,Print
5/26/2020,$2.84,$0.00,$3960.65,Print
5/26/2020,$2.74,$0.00,$3957.91,Print
5/26/2020,$3.25,$0.00,$3954.66,Print
5/26/2020,$3.25,$0.00,$3951.41,Print
5/26/2020,$2.78,$0.00,$3948.63,Print
5/26/2020,$2.76,$0.00,$3945.87,Print
5/26/2020,$4.00,$0.00,$3941.87,Print
5/26/2020,$3.25,$0.00,$3938.62,Print
5/26/2020,$3.93,$0.00,$3934.69,Print
5/26/2020,$2.93,$0.00,$3931.76,Print
5/26/2020,$2.74,$0.00,$3929.02,Print
5/26/2020,$2.76,$0.00,$3926.26,Print
5/26/2020,$2.74,$0.00,$3923.52,Print
5/26/2020,$2.78,$0.00,$3920.74,Print
5/26/2020,$2.84,$0.00,$3917.90,Print
5/26/2020,$2.84,$0.00,$3915.06,Print
5/26/2020,$2.84,$0.00,$3912.22,Print
5/26/2020,$3.21,$0.00,$3910.25,Print
5/26/2020,$2.84,$0.00,$3907.41,Print
5/26/2020,$3.25,$0.00,$3904.16,Print
5/26/2020,$2.78,$0.00,$3901.38,Print
5/26/2020,$3.25,$0.00,$3898.13,Print
5/26/2020,$3.25,$0.00,$3894.88,Print
5/26/2020,$2.84,$0.00,$3892.04,Print
5/26/2020,$3.25,$0.00,$3888.79,Print
5/26/2020,$2.74,$0.00,$3886.05,Print
5/26/2020,$4.08,$0.00,$3881.97,Print
5/26/2020,$1.19,$0.00,$3880.78,Adjustment
5/26/2020,$2.74,$0.00,$3878.04,Print
5/26/2020,$2.74,$0.00,$3875.30,Print
5/26/2020,$1.19,$0.00,$3874.11,Adjustment
5/26/2020,$2.78,$0.00,$3871.33,Print
5/26/2020,$5.40,$0.00,$3865.93,Print
5/26/2020,$2.76,$0.00,$3863.17,Print
5/26/2020,$2.74,$0.00,$3860.43,Print
5/26/2020,$2.76,$0.00,$3857.67,Print
5/26/2020,$2.78,$0.00,$3854.89,Print
5/26/2020,$3.23,$0.00,$3851.66,Print
5/26/2020,$2.74,$0.00,$3848.92,Print
5/26/2020,$2.84,$0.00,$3846.08,Print
5/26/2020,$2.78,$0.00,$3843.30,Print
5/26/2020,$2.84,$0.00,$3840.46,Print
5/26/2020,$1.19,$0.00,$3839.27,Adjustment
5/26/2020,$2.74,$0.00,$3836.53,Print
5/26/2020,$2.84,$0.00,$3833.69,Print
5/26/2020,$2.93,$0.00,$3830.76,Print
5/26/2020,$4.00,$0.00,$3826.76,Print
5/26/2020,$2.84,$0.00,$3823.92,Print
5/26/2020,$2.84,$0.00,$3821.08,Print
5/26/2020,$2.78,$0.00,$3818.30,Print
5/26/2020,$1.22,$0.00,$3817.08,Adjustment
5/26/2020,$1.21,$0.00,$3815.87,Adjustment
5/26/2020,$1.21,$0.00,$3814.66,Adjustment
5/26/2020,$3.25,$0.00,$3811.41,Print
5/26/2020,$2.76,$0.00,$3808.65,Print
5/26/2020,$2.84,$0.00,$3805.81,Print
5/26/2020,$3.31,$0.00,$3802.50,Print
5/26/2020,$2.78,$0.00,$3799.72,Print
5/26/2020,$2.78,$0.00,$3796.94,Print
5/26/2020,$2.76,$0.00,$3794.18,Print
5/26/2020,$2.84,$0.00,$3791.34,Print
5/26/2020,$2.76,$0.00,$3788.58,Print
5/26/2020,$2.74,$0.00,$3785.84,Print
5/26/2020,$2.76,$0.00,$3783.08,Print
5/26/2020,$2.93,$0.00,$3780.15,Print
5/26/2020,$1.22,$0.00,$3778.93,Adjustment
5/26/2020,$2.78,$0.00,$3776.15,Print
5/26/2020,$2.74,$0.00,$3773.41,Print
5/26/2020,$1.22,$0.00,$3772.19,Adjustment
5/26/2020,$1.21,$0.00,$3770.98,Adjustment
5/26/2020,$1.22,$0.00,$3769.76,Adjustment
5/26/2020,$1.21,$0.00,$3768.55,Adjustment
5/26/2020,$2.76,$0.00,$3765.79,Print
5/26/2020,$1.22,$0.00,$3764.57,Adjustment
5/26/2020,$1.22,$0.00,$3763.35,Adjustment
5/26/2020,$3.52,$0.00,$3759.83,Print
5/26/2020,$1.22,$0.00,$3758.61,Adjustment
5/26/2020,$1.22,$0.00,$3757.39,Adjustment
5/26/2020,$1.22,$0.00,$3756.17,Adjustment
5/26/2020,$1.22,$0.00,$3754.95,Adjustment
5/26/2020,$3.31,$0.00,$3751.64,Print
5/26/2020,$3.23,$0.00,$3748.41,Print
5/26/2020,$3.25,$0.00,$3745.16,Print
5/26/2020,$4.00,$0.00,$3741.16,Print
5/26/2020,$3.97,$0.00,$3737.19,Print
5/26/2020,$3.97,$0.00,$3733.22,Print
5/26/2020,$3.97,$0.00,$3729.25,Print
5/26/2020,$4.18,$0.00,$3725.07,Print
5/26/2020,$3.31,$0.00,$3721.76,Print
5/26/2020,$3.97,$0.00,$3717.79,Print
5/26/2020,$3.93,$0.00,$3713.86,Print
5/26/2020,$4.08,$0.00,$3709.78,Print
5/26/2020,$4.00,$0.00,$3705.78,Print
5/26/2020,$3.97,$0.00,$3701.81,Print
5/26/2020,$3.25,$0.00,$3698.56,Print
5/26/2020,$3.93,$0.00,$3694.63,Print
5/26/2020,$2.76,$0.00,$3691.87,Print
5/26/2020,$2.78,$0.00,$3689.09,Print
5/26/2020,$3.93,$0.00,$3685.16,Print
5/26/2020,$4.08,$0.00,$3681.08,Print
5/26/2020,$2.74,$0.00,$3678.34,Print
5/26/2020,$4.00,$0.00,$3674.34,Print
5/26/2020,$3.25,$0.00,$3671.09,Print
5/26/2020,$3.25,$0.00,$3667.84,Print
5/26/2020,$2.84,$0.00,$3665.00,Print
5/26/2020,$3.25,$0.00,$3661.75,Print
5/26/2020,$3.25,$0.00,$3658.50,Print
5/26/2020,$3.25,$0.00,$3655.25,Print
5/26/2020,$2.78,$0.00,$3652.47,Print
5/26/2020,$5.40,$0.00,$3647.07,Print
5/26/2020,$3.52,$0.00,$3643.55,Print
5/26/2020,$5.12,$0.00,$3638.43,Print
5/26/2020,$5.12,$0.00,$3633.31,Print
5/26/2020,$2.74,$0.00,$3630.57,Print
5/26/2020,$2.78,$0.00,$3627.79,Print
5/26/2020,$3.31,$0.00,$3624.48,Print
5/26/2020,$2.78,$0.00,$3621.70,Print
5/26/2020,$2.74,$0.00,$3618.96,Print
5/26/2020,$2.78,$0.00,$3616.18,Print
5/26/2020,$2.74,$0.00,$3613.44,Print
5/26/2020,$4.00,$0.00,$3609.44,Print
5/26/2020,$3.93,$0.00,$3605.51,Print
5/26/2020,$3.97,$0.00,$3601.54,Print
5/26/2020,$4.00,$0.00,$3597.54,Print
5/26/2020,$2.84,$0.00,$3594.70,Print
5/26/2020,$3.97,$0.00,$3590.73,Print
5/26/2020,$3.31,$0.00,$3587.42,Print
5/26/2020,$3.25,$0.00,$3584.17,Print
5/26/2020,$2.84,$0.00,$3581.33,Print
5/26/2020,$4.00,$0.00,$3577.33,Print
5/26/2020,$2.84,$0.00,$3574.49,Print
5/26/2020,$2.74,$0.00,$3571.75,Print
5/26/2020,$2.93,$0.00,$3568.82,Print
5/26/2020,$2.78,$0.00,$3566.04,Print
5/26/2020,$2.74,$0.00,$3563.30,Print
5/26/2020,$2.74,$0.00,$3560.56,Print
5/26/2020,$4.18,$0.00,$3556.38,Print
5/26/2020,$4.08,$0.00,$3552.30,Print
5/26/2020,$4.00,$0.00,$3548.30,Print
5/26/2020,$2.84,$0.00,$3545.46,Print
5/26/2020,$2.84,$0.00,$3542.62,Print
5/26/2020,$8.59,$0.00,$3534.03,Print
5/26/2020,$3.31,$0.00,$3530.72,Print
5/26/2020,$2.76,$0.00,$3527.96,Print
5/26/2020,$2.76,$0.00,$3525.20,Print
5/26/2020,$3.25,$0.00,$3521.95,Print
5/26/2020,$2.78,$0.00,$3519.17,Print
5/26/2020,$2.74,$0.00,$3516.43,Print
5/26/2020,$3.25,$0.00,$3513.18,Print
5/26/2020,$4.00,$0.00,$3509.18,Print
5/26/2020,$3.21,$0.00,$3505.97,Print
5/26/2020,$3.25,$0.00,$3502.72,Print
5/26/2020,$2.84,$0.00,$3499.88,Print
5/26/2020,$3.05,$0.00,$3496.83,Print
5/26/2020,$2.74,$0.00,$3494.09,Print
5/26/2020,$2.78,$0.00,$3491.31,Print
5/26/2020,$2.78,$0.00,$3488.53,Print
5/26/2020,$2.76,$0.00,$3485.77,Print
5/26/2020,$3.21,$0.00,$3482.56,Print
5/26/2020,$2.76,$0.00,$3479.80,Print
5/26/2020,$2.78,$0.00,$3477.02,Print
5/26/2020,$2.78,$0.00,$3474.24,Print
5/26/2020,$4.08,$0.00,$3470.16,Print
5/26/2020,$3.52,$0.00,$3466.64,Print
5/26/2020,$3.23,$0.00,$3463.41,Print
5/26/2020,$3.25,$0.00,$3460.16,Print
5/26/2020,$3.31,$0.00,$3456.85,Print
5/26/2020,$2.74,$0.00,$3454.11,Print
5/26/2020,$2.78,$0.00,$3451.33,Print
5/26/2020,$2.78,$0.00,$3448.55,Print
5/26/2020,$3.25,$0.00,$3445.30,Print
5/26/2020,$2.76,$0.00,$3442.54,Print
5/26/2020,$2.74,$0.00,$3439.80,Print
5/26/2020,$2.84,$0.00,$3436.96,Print
5/26/2020,$2.84,$0.00,$3434.12,Print
5/26/2020,$3.25,$0.00,$3430.87,Print
5/26/2020,$3.21,$0.00,$3427.66,Print
5/26/2020,$4.08,$0.00,$3423.58,Print
5/26/2020,$2.84,$0.00,$3420.74,Print
5/26/2020,$3.97,$0.00,$3416.77,Print
5/26/2020,$2.78,$0.00,$3413.99,Print
5/26/2020,$4.00,$0.00,$3409.99,Print
5/26/2020,$2.78,$0.00,$3407.21,Print
5/26/2020,$2.74,$0.00,$3404.47,Print
5/26/2020,$4.08,$0.00,$3400.39,Print
5/26/2020,$2.74,$0.00,$3397.65,Print
5/26/2020,$3.05,$0.00,$3394.60,Print
5/26/2020,$3.05,$0.00,$3391.55,Print
5/26/2020,$4.08,$0.00,$3387.47,Print
5/26/2020,$2.78,$0.00,$3384.69,Print
5/26/2020,$2.84,$0.00,$3381.85,Print
5/26/2020,$2.78,$0.00,$3379.07,Print
5/26/2020,$2.78,$0.00,$3377.51,Print
5/26/2020,$2.78,$0.00,$3381.98,Print
5/26/2020,$2.74,$0.00,$3379.24,Print
5/26/2020,$2.78,$0.00,$3376.46,Print
5/26/2020,$3.05,$0.00,$3373.41,Print
5/26/2020,$3.25,$0.00,$3370.16,Print
5/26/2020,$2.78,$0.00,$3367.38,Print
5/26/2020,$18.14,$0.00,$3349.24,Print
5/26/2020,$3.05,$0.00,$3346.19,Print
5/26/2020,$2.84,$0.00,$3343.35,Print
5/26/2020,$2.84,$0.00,$3340.51,Print
5/26/2020,$2.78,$0.00,$3337.73,Print
5/26/2020,$2.78,$0.00,$3334.95,Print
5/26/2020,$2.76,$0.00,$3332.19,Print
5/26/2020,$2.74,$0.00,$3329.45,Print
5/26/2020,$2.78,$0.00,$3326.67,Print
5/26/2020,$3.39,$0.00,$3323.28,Print
5/26/2020,$2.74,$0.00,$3320.54,Print
5/26/2020,$2.84,$0.00,$3317.70,Print
5/26/2020,$2.84,$0.00,$3314.86,Print
5/26/2020,$2.84,$0.00,$3312.02,Print
5/26/2020,$2.78,$0.00,$3309.24,Print
5/26/2020,$3.21,$0.00,$3306.03,Print
5/26/2020,$3.93,$0.00,$3302.10,Print
5/26/2020,$2.84,$0.00,$3299.26,Print
5/26/2020,$2.78,$0.00,$3296.48,Print
5/26/2020,$4.18,$0.00,$3292.30,Print
5/26/2020,$3.25,$0.00,$3289.05,Print
5/26/2020,$2.84,$0.00,$3286.21,Print
5/26/2020,$3.93,$0.00,$3282.28,Print
5/26/2020,$4.00,$0.00,$3278.28,Print
5/26/2020,$3.05,$0.00,$3275.23,Print
5/26/2020,$2.76,$0.00,$3272.47,Print
5/26/2020,$3.21,$0.00,$3269.26,Print
5/26/2020,$2.74,$0.00,$3266.52,Print
5/26/2020,$2.76,$0.00,$3263.76,Print
5/26/2020,$2.84,$0.00,$3260.92,Print
5/26/2020,$2.78,$0.00,$3258.14,Print
5/26/2020,$2.74,$0.00,$3255.40,Print
5/26/2020,$3.21,$0.00,$3252.19,Print
5/26/2020,$2.78,$0.00,$3249.41,Print
5/26/2020,$2.76,$0.00,$3246.65,Print
5/26/2020,$3.39,$0.00,$3243.26,Print
5/26/2020,$2.78,$0.00,$3240.48,Print
5/26/2020,$2.78,$0.00,$3237.70,Print
5/26/2020,$3.25,$0.00,$3234.45,Print
5/26/2020,$3.39,$0.00,$3231.06,Print
5/26/2020,$3.21,$0.00,$3227.85,Print
5/26/2020,$3.31,$0.00,$3224.54,Print
5/26/2020,$3.25,$0.00,$3221.29,Print
5/26/2020,$4.08,$0.00,$3217.21,Print
5/26/2020,$2.84,$0.00,$3214.37,Print
5/26/2020,$2.84,$0.00,$3211.53,Print
5/26/2020,$2.78,$0.00,$3208.75,Print
5/26/2020,$2.93,$0.00,$3205.82,Print
5/26/2020,$2.93,$0.00,$3202.89,Print
5/26/2020,$2.84,$0.00,$3200.05,Print
5/26/2020,$4.00,$0.00,$3196.05,Print
5/26/2020,$2.76,$0.00,$3193.29,Print
5/26/2020,$3.21,$0.00,$3190.08,Print
5/26/2020,$3.31,$0.00,$3186.77,Print
5/26/2020,$3.25,$0.00,$3183.52,Print
5/26/2020,$2.74,$0.00,$3180.78,Print
5/26/2020,$3.23,$0.00,$3177.55,Print
5/26/2020,$5.04,$0.00,$3172.51,Print
5/26/2020,$2.84,$0.00,$3169.67,Print
5/26/2020,$3.25,$0.00,$3166.42,Print
5/26/2020,$3.23,$0.00,$3163.19,Print
5/26/2020,$3.25,$0.00,$3159.94,Print
5/26/2020,$2.78,$0.00,$3157.16,Print
5/26/2020,$2.74,$0.00,$3154.42,Print
5/26/2020,$2.78,$0.00,$3151.64,Print
5/26/2020,$3.31,$0.00,$3148.33,Print
5/26/2020,$2.84,$0.00,$3145.49,Print
5/26/2020,$3.05,$0.00,$3142.44,Print
5/26/2020,$3.93,$0.00,$3138.51,Print
5/26/2020,$2.76,$0.00,$3135.75,Print
5/26/2020,$3.21,$0.00,$3132.54,Print
5/26/2020,$3.21,$0.00,$3129.33,Print
5/26/2020,$4.18,$0.00,$3125.15,Print
5/26/2020,$3.23,$0.00,$3121.92,Print
5/26/2020,$2.74,$0.00,$3119.18,Print
5/26/2020,$3.25,$0.00,$3115.93,Print
5/26/2020,$3.93,$0.00,$3112.00,Print
5/26/2020,$2.74,$0.00,$3109.26,Print
5/26/2020,$2.74,$0.00,$3106.52,Print
5/26/2020,$2.74,$0.00,$3103.78,Print
5/26/2020,$2.74,$0.00,$3101.04,Print
5/26/2020,$2.74,$0.00,$3098.30,Print
5/26/2020,$3.21,$0.00,$3095.09,Print
5/26/2020,$2.76,$0.00,$3092.33,Print
5/26/2020,$2.84,$0.00,$3089.49,Print
5/26/2020,$3.52,$0.00,$3085.97,Print
5/26/2020,$2.78,$0.00,$3083.19,Print
5/26/2020,$2.74,$0.00,$3080.45,Print
5/26/2020,$5.08,$0.00,$3075.37,Print
5/26/2020,$2.76,$0.00,$3072.61,Print
5/26/2020,$38.13,$0.00,$3034.48,Print
5/26/2020,$42.18,$0.00,$2992.30,Print
5/26/2020,$2.76,$0.00,$2989.54,Print
5/26/2020,$3.05,$0.00,$2986.49,Print
5/26/2020,$2.84,$0.00,$2983.65,Print
5/26/2020,$2.84,$0.00,$2980.81,Print
5/26/2020,$3.05,$0.00,$2977.76,Print
5/26/2020,$3.25,$0.00,$2974.51,Print
5/26/2020,$3.25,$0.00,$2971.26,Print
5/26/2020,$2.74,$0.00,$2968.52,Print
5/26/2020,$2.84,$0.00,$2965.68,Print
5/26/2020,$2.84,$0.00,$2962.84,Print
5/26/2020,$2.78,$0.00,$2960.06,Print
5/26/2020,$2.76,$0.00,$2957.30,Print
5/26/2020,$2.74,$0.00,$2954.56,Print
5/26/2020,$4.18,$0.00,$2950.38,Print
5/26/2020,$3.05,$0.00,$2947.33,Print
5/26/2020,$3.52,$0.00,$2943.81,Print
5/26/2020,$3.25,$0.00,$2940.56,Print
5/26/2020,$3.21,$0.00,$2937.35,Print
5/26/2020,$3.25,$0.00,$2934.10,Print
5/26/2020,$2.74,$0.00,$2931.36,Print
5/26/2020,$3.52,$0.00,$2927.84,Print
5/26/2020,$5.04,$0.00,$2922.80,Print
5/26/2020,$3.52,$0.00,$2919.28,Print
5/26/2020,$3.25,$0.00,$2916.03,Print
5/26/2020,$2.84,$0.00,$2913.19,Print
5/26/2020,$2.74,$0.00,$2910.45,Print
5/26/2020,$2.74,$0.00,$2907.71,Print
5/26/2020,$3.21,$0.00,$2904.50,Print
5/26/2020,$2.78,$0.00,$2901.72,Print
5/26/2020,$2.78,$0.00,$2898.94,Print
5/26/2020,$3.21,$0.00,$2895.73,Print
5/26/2020,$3.31,$0.00,$2892.42,Print
5/26/2020,$2.74,$0.00,$2889.68,Print
5/26/2020,$2.74,$0.00,$2886.94,Print
5/26/2020,$3.21,$0.00,$2883.73,Print
5/26/2020,$3.23,$0.00,$2880.50,Print
5/26/2020,$2.74,$0.00,$2877.76,Print
5/26/2020,$3.23,$0.00,$2874.53,Print
5/26/2020,$2.76,$0.00,$2871.77,Print
5/26/2020,$2.74,$0.00,$2869.03,Print
5/26/2020,$3.31,$0.00,$2865.72,Print
5/26/2020,$3.31,$0.00,$2862.41,Print
5/26/2020,$3.93,$0.00,$2858.48,Print
5/26/2020,$3.31,$0.00,$2855.17,Print
5/26/2020,$2.84,$0.00,$2852.33,Print
5/26/2020,$2.78,$0.00,$2849.55,Print
5/26/2020,$3.05,$0.00,$2846.50,Print
5/26/2020,$2.84,$0.00,$2843.66,Print
5/26/2020,$3.52,$0.00,$2840.14,Print
5/26/2020,$3.52,$0.00,$2836.62,Print
5/26/2020,$3.31,$0.00,$2833.31,Print
5/26/2020,$3.31,$0.00,$2830.00,Print
5/26/2020,$3.52,$0.00,$2826.48,Print
5/26/2020,$7.80,$0.00,$2818.68,Print
5/26/2020,$7.80,$0.00,$2810.88,Print
5/26/2020,$2.78,$0.00,$2808.10,Print
5/26/2020,$2.84,$0.00,$2805.26,Print
5/26/2020,$2.74,$0.00,$2802.52,Print
5/26/2020,$2.84,$0.00,$2799.68,Print
5/26/2020,$2.84,$0.00,$2796.84,Print
5/26/2020,$2.84,$0.00,$2794.00,Print
5/26/2020,$3.31,$0.00,$2790.69,Print
5/26/2020,$3.31,$0.00,$2787.38,Print
5/26/2020,$2.84,$0.00,$2784.54,Print
5/26/2020,$3.52,$0.00,$2781.02,Print
5/26/2020,$3.31,$0.00,$2777.71,Print
5/26/2020,$3.25,$0.00,$2774.46,Print
5/26/2020,$3.31,$0.00,$2771.15,Print
5/26/2020,$3.52,$0.00,$2767.63,Print
5/26/2020,$3.31,$0.00,$2764.32,Print
5/26/2020,$3.39,$0.00,$2760.93,Print
5/26/2020,$3.52,$0.00,$2757.41,Print
5/26/2020,$3.05,$0.00,$2754.36,Print
5/26/2020,$2.74,$0.00,$2751.62,Print
5/26/2020,$3.31,$0.00,$2748.31,Print
5/26/2020,$3.25,$0.00,$2745.06,Print
5/26/2020,$3.05,$0.00,$2742.01,Print
5/26/2020,$3.23,$0.00,$2738.78,Print
5/26/2020,$3.21,$0.00,$2735.57,Print
5/26/2020,$4.08,$0.00,$2731.49,Print
5/26/2020,$3.05,$0.00,$2728.44,Print
5/26/2020,$4.18,$0.00,$2724.26,Print
5/26/2020,$2.78,$0.00,$2721.48,Print
5/26/2020,$3.21,$0.00,$2718.27,Print
5/26/2020,$4.08,$0.00,$2714.19,Print
5/26/2020,$3.21,$0.00,$2710.98,Print
5/26/2020,$3.23,$0.00,$2707.75,Print
5/26/2020,$3.39,$0.00,$2704.36,Print
5/26/2020,$3.23,$0.00,$2701.13,Print
5/26/2020,$3.31,$0.00,$2697.82,Print
5/26/2020,$4.08,$0.00,$2693.74,Print
5/26/2020,$4.32,$0.00,$2689.42,Print
5/26/2020,$3.31,$0.00,$2686.11,Print
5/26/2020,$3.25,$0.00,$2682.86,Print
5/26/2020,$3.93,$0.00,$2678.93,Print
5/26/2020,$3.31,$0.00,$2675.62,Print
5/26/2020,$2.84,$0.00,$2672.78,Print
5/26/2020,$2.78,$0.00,$2670.00,Print
5/26/2020,$3.31,$0.00,$2666.69,Print
5/26/2020,$3.21,$0.00,$2663.48,Print
5/26/2020,$3.25,$0.00,$2660.23,Print
5/26/2020,$3.23,$0.00,$2657.00,Print
5/26/2020,$3.21,$0.00,$2653.79,Print
5/26/2020,$3.31,$0.00,$2650.48,Print
5/26/2020,$3.21,$0.00,$2647.27,Print
5/26/2020,$3.21,$0.00,$2644.06,Print
5/26/2020,$2.84,$0.00,$2641.22,Print
5/26/2020,$2.78,$0.00,$2638.44,Print
5/26/2020,$3.25,$0.00,$2635.19,Print
5/26/2020,$2.84,$0.00,$2632.35,Print
5/26/2020,$2.76,$0.00,$2629.59,Print
5/26/2020,$3.39,$0.00,$2626.20,Print
5/26/2020,$2.84,$0.00,$2623.36,Print
5/26/2020,$3.31,$0.00,$2620.05,Print
5/26/2020,$2.84,$0.00,$2617.21,Print
5/26/2020,$3.25,$0.00,$2613.96,Print
5/26/2020,$2.84,$0.00,$2611.12,Print
5/26/2020,$2.84,$0.00,$2608.28,Print
5/26/2020,$2.76,$0.00,$2605.52,Print
5/26/2020,$2.74,$0.00,$2602.78,Print
5/26/2020,$2.84,$0.00,$2599.94,Print
5/26/2020,$2.76,$0.00,$2597.18,Print
5/26/2020,$2.76,$0.00,$2594.42,Print
5/26/2020,$2.76,$0.00,$2591.66,Print
5/26/2020,$2.93,$0.00,$2588.73,Print
5/26/2020,$3.21,$0.00,$2585.52,Print
5/26/2020,$3.25,$0.00,$2582.27,Print
5/26/2020,$3.39,$0.00,$2578.88,Print
5/26/2020,$3.31,$0.00,$2575.57,Print
5/26/2020,$2.84,$0.00,$2572.73,Print
5/26/2020,$2.84,$0.00,$2569.89,Print
5/26/2020,$2.93,$0.00,$2566.96,Print
5/26/2020,$3.25,$0.00,$2563.71,Print
5/26/2020,$2.74,$0.00,$2560.97,Print
5/26/2020,$9.07,$0.00,$2551.90,Print
5/26/2020,$2.84,$0.00,$2549.06,Print
5/26/2020,$2.84,$0.00,$2546.22,Print
5/26/2020,$2.84,$0.00,$2543.38,Print
5/26/2020,$2.84,$0.00,$2540.54,Print
5/26/2020,$4.32,$0.00,$2536.22,Print
5/26/2020,$4.32,$0.00,$2531.90,Print
5/26/2020,$3.25,$0.00,$2528.65,Print
5/26/2020,$2.93,$0.00,$2525.72,Print
5/26/2020,$2.84,$0.00,$2522.88,Print
5/26/2020,$2.84,$0.00,$2520.04,Print
5/26/2020,$2.84,$0.00,$2517.20,Print
5/26/2020,$2.93,$0.00,$2514.27,Print
5/26/2020,$2.84,$0.00,$2511.43,Print
5/26/2020,$2.84,$0.00,$2508.59,Print
5/26/2020,$2.84,$0.00,$2505.75,Print
5/26/2020,$2.78,$0.00,$2502.97,Print
5/26/2020,$3.31,$0.00,$2499.66,Print
5/26/2020,$2000.00,$0.00,$4499.66,Purchase
5/26/2020,$2.74,$0.00,$4496.92,Print
5/26/2020,$2.78,$0.00,$4494.14,Print
5/26/2020,$2.84,$0.00,$4491.30,Print
5/26/2020,$2.76,$0.00,$4488.54,Print
5/26/2020,$2.76,$0.00,$4485.78,Print
5/26/2020,$9.54,$0.00,$4476.24,Print
5/26/2020,$2.78,$0.00,$4473.46,Print
5/26/2020,$2.76,$0.00,$4470.70,Print
5/26/2020,$2.84,$0.00,$4467.86,Print
5/26/2020,$2.78,$0.00,$4465.08,Print
5/26/2020,$2.76,$0.00,$4462.32,Print
5/26/2020,$3.05,$0.00,$4459.27,Print
5/26/2020,$2.93,$0.00,$4456.34,Print
5/26/2020,$2.84,$0.00,$4453.50,Print
5/26/2020,$2.74,$0.00,$4450.76,Print
5/26/2020,$2.74,$0.00,$4448.02,Print
5/26/2020,$2.84,$0.00,$4445.18,Print
5/26/2020,$2.74,$0.00,$4442.44,Print
5/26/2020,$2.84,$0.00,$4439.60,Print
5/26/2020,$2.84,$0.00,$4436.76,Print
5/26/2020,$2.74,$0.00,$4434.02,Print
5/26/2020,$2.76,$0.00,$4431.26,Print
5/26/2020,$2.84,$0.00,$4428.42,Print
5/26/2020,$2.84,$0.00,$4425.58,Print
5/26/2020,$2.78,$0.00,$4422.80,Print
5/26/2020,$2.84,$0.00,$4419.96,Print
5/26/2020,$2.74,$0.00,$4417.22,Print
5/26/2020,$2.84,$0.00,$4414.38,Print
5/26/2020,$2.84,$0.00,$4411.54,Print
5/26/2020,$2.84,$0.00,$4408.70,Print
5/26/2020,$2.78,$0.00,$4405.92,Print
5/26/2020,$2.84,$0.00,$4403.08,Print
5/26/2020,$2.78,$0.00,$4400.30,Print
5/26/2020,$2.78,$0.00,$4397.52,Print
5/26/2020,$2.84,$0.00,$4394.68,Print
5/26/2020,$2.74,$0.00,$4391.94,Print
5/26/2020,$2.84,$0.00,$4389.10,Print
5/26/2020,$2.84,$0.00,$4386.26,Print
5/26/2020,$2.84,$0.00,$4383.42,Print
5/26/2020,$2.78,$0.00,$4380.64,Print
5/26/2020,$2.84,$0.00,$4377.80,Print
5/26/2020,$2.78,$0.00,$4375.02,Print
5/26/2020,$2.84,$0.00,$4372.18,Print
5/26/2020,$2.78,$0.00,$4369.40,Print
5/26/2020,$2.84,$0.00,$4366.56,Print
5/26/2020,$2.74,$0.00,$4363.82,Print
5/26/2020,$2.78,$0.00,$4361.04,Print
5/26/2020,$2.78,$0.00,$4358.26,Print
5/26/2020,$2.84,$0.00,$4355.42,Print
5/26/2020,$2.84,$0.00,$4352.58,Print
5/26/2020,$2.78,$0.00,$4349.80,Print
5/26/2020,$2.84,$0.00,$4346.96,Print
5/26/2020,$2.78,$0.00,$4344.18,Print
5/26/2020,$2.78,$0.00,$4341.40,Print
5/26/2020,$2.84,$0.00,$4338.56,Print
5/26/2020,$2.84,$0.00,$4335.72,Print
5/26/2020,$2.78,$0.00,$4332.94,Print
5/26/2020,$2.84,$0.00,$4330.10,Print
5/26/2020,$2.74,$0.00,$4327.36,Print
5/26/2020,$2.78,$0.00,$4324.58,Print
5/26/2020,$2.78,$0.00,$4321.80,Print
5/26/2020,$2.76,$0.00,$4319.04,Print
5/26/2020,$2.93,$0.00,$4316.11,Print
5/26/2020,$2.76,$0.00,$4313.35,Print
5/26/2020,$2.74,$0.00,$4310.61,Print
5/26/2020,$2.78,$0.00,$4307.83,Print
5/26/2020,$2.84,$0.00,$4304.99,Print
5/26/2020,$5.27,$0.00,$4299.72,Print
5/26/2020,$5.08,$0.00,$4294.64,Print
5/26/2020,$5.08,$0.00,$4289.56,Print
5/26/2020,$5.27,$0.00,$4284.29,Print
5/26/2020,$5.08,$0.00,$4279.21,Print
5/26/2020,$5.27,$0.00,$4273.94,Print
5/26/2020,$3.23,$0.00,$4270.71,Print
5/26/2020,$2.76,$0.00,$4267.95,Print
5/26/2020,$5.12,$0.00,$4262.83,Print
5/26/2020,$3.25,$0.00,$4259.58,Print
5/26/2020,$2.78,$0.00,$4256.80,Print
5/26/2020,$3.25,$0.00,$4253.55,Print
5/26/2020,$2.74,$0.00,$4250.81,Print
5/26/2020,$2.76,$0.00,$4248.05,Print
5/26/2020,$2.74,$0.00,$4245.31,Print
5/26/2020,$3.21,$0.00,$4242.10,Print
5/26/2020,$2.74,$0.00,$4239.36,Print
5/26/2020,$3.25,$0.00,$4236.11,Print
5/26/2020,$2.74,$0.00,$4233.37,Print
5/26/2020,$2.76,$0.00,$4230.61,Print
5/26/2020,$3.93,$0.00,$4226.68,Print
5/26/2020,$3.31,$0.00,$4223.37,Print
5/26/2020,$3.23,$0.00,$4220.14,Print
5/26/2020,$0.00,$2.34,$4222.48,Adjustment
5/26/2020,$2.84,$0.00,$4219.64,Print
5/26/2020,$3.23,$0.00,$4216.41,Print
5/26/2020,$3.21,$0.00,$4213.20,Print
5/26/2020,$2.78,$0.00,$4210.42,Print
5/26/2020,$2.74,$0.00,$4207.68,Print
5/26/2020,$2.78,$0.00,$4204.90,Print
5/26/2020,$2.84,$0.00,$4202.06,Print
5/26/2020,$2.84,$0.00,$4199.22,Print
5/26/2020,$2.84,$0.00,$4196.38,Print
5/26/2020,$2.84,$0.00,$4193.54,Print
5/26/2020,$2.84,$0.00,$4190.70,Print
5/26/2020,$2.74,$0.00,$4187.96,Print
5/26/2020,$2.78,$0.00,$4185.18,Print
5/26/2020,$2.84,$0.00,$4182.34,Print
5/26/2020,$2.84,$0.00,$4179.50,Print
5/26/2020,$2.84,$0.00,$4176.66,Print
5/26/2020,$2.74,$0.00,$4173.92,Print
5/26/2020,$3.39,$0.00,$4170.53,Print
5/26/2020,$2.78,$0.00,$4167.75,Print
5/26/2020,$2.84,$0.00,$4164.91,Print
5/26/2020,$3.31,$0.00,$4161.60,Print
5/26/2020,$2.76,$0.00,$4158.84,Print
5/26/2020,$2.93,$0.00,$4155.91,Print
5/26/2020,$2.78,$0.00,$4153.13,Print
5/26/2020,$2.84,$0.00,$4150.29,Print
5/26/2020,$2.84,$0.00,$4147.45,Print
5/26/2020,$2.78,$0.00,$4144.67,Print
5/26/2020,$3.23,$0.00,$4141.44,Print
5/26/2020,$2.78,$0.00,$4138.66,Print
5/26/2020,$5.27,$0.00,$4133.39,Print
5/26/2020,$2.93,$0.00,$4130.46,Print
5/26/2020,$2.84,$0.00,$4127.62,Print
5/26/2020,$2.84,$0.00,$4124.78,Print
5/26/2020,$4.00,$0.00,$4120.78,Print
5/26/2020,$2.78,$0.00,$4118.00,Print
5/26/2020,$2.78,$0.00,$4115.22,Print
5/26/2020,$2.84,$0.00,$4112.38,Print
5/26/2020,$2.76,$0.00,$4109.62,Print
5/26/2020,$2.76,$0.00,$4106.86,Print
5/27/2020,$3.23,$0.00,$4103.63,Print
5/27/2020,$4.32,$0.00,$4099.31,Print
5/27/2020,$3.23,$0.00,$4096.08,Print
5/27/2020,$2.84,$0.00,$4093.24,Print
5/27/2020,$2.76,$0.00,$4090.48,Print
5/27/2020,$2.84,$0.00,$4087.64,Print
5/27/2020,$2.78,$0.00,$4084.86,Print
5/27/2020,$2.84,$0.00,$4082.02,Print
5/27/2020,$2.84,$0.00,$4079.18,Print
5/27/2020,$2.74,$0.00,$4076.44,Print
5/27/2020,$2.78,$0.00,$4073.66,Print
5/27/2020,$2.76,$0.00,$4070.90,Print
5/27/2020,$2.78,$0.00,$4068.12,Print
5/27/2020,$2.74,$0.00,$4065.38,Print
5/27/2020,$2.84,$0.00,$4062.54,Print
5/27/2020,$2.84,$0.00,$4059.70,Print
5/27/2020,$2.78,$0.00,$4056.92,Print
5/27/2020,$2.84,$0.00,$4054.08,Print
5/27/2020,$2.76,$0.00,$4051.32,Print
5/27/2020,$2.78,$0.00,$4048.54,Print
5/27/2020,$2.78,$0.00,$4045.76,Print
5/27/2020,$2.78,$0.00,$4042.98,Print
5/27/2020,$2.76,$0.00,$4040.22,Print
5/27/2020,$2.78,$0.00,$4037.44,Print
5/27/2020,$2.76,$0.00,$4034.68,Print
5/27/2020,$3.25,$0.00,$4031.43,Print
5/27/2020,$2.78,$0.00,$4028.65,Print
5/27/2020,$5.54,$0.00,$4023.11,Print
5/27/2020,$2.74,$0.00,$4020.37,Print
5/27/2020,$2.74,$0.00,$4017.63,Print
5/27/2020,$2.84,$0.00,$4014.79,Print
5/27/2020,$2.78,$0.00,$4012.01,Print
5/27/2020,$2.84,$0.00,$4009.17,Print
5/27/2020,$2.84,$0.00,$4006.33,Print
5/27/2020,$2.78,$0.00,$4003.55,Print
5/27/2020,$2.93,$0.00,$4000.62,Print
5/27/2020,$1.24,$0.00,$3999.38,Adjustment
5/27/2020,$1.24,$0.00,$3998.14,Adjustment
5/27/2020,$2.78,$0.00,$3995.36,Print
5/27/2020,$3.39,$0.00,$3991.97,Print
5/27/2020,$1.24,$0.00,$3990.73,Adjustment
5/27/2020,$1.24,$0.00,$3989.49,Adjustment
5/27/2020,$2.76,$0.00,$3986.73,Print
5/27/2020,$1.24,$0.00,$3985.49,Adjustment
5/27/2020,$7.02,$0.00,$3991.51,Print
5/27/2020,$2.74,$0.00,$3988.77,Print
5/27/2020,$2.84,$0.00,$3985.93,Print
5/27/2020,$2.78,$0.00,$3983.15,Print
5/27/2020,$2.78,$0.00,$3980.37,Print
5/27/2020,$2.84,$0.00,$3977.53,Print
5/27/2020,$2.84,$0.00,$3974.69,Print
5/27/2020,$2.76,$0.00,$3971.93,Print
5/27/2020,$2.84,$0.00,$3969.09,Print
5/27/2020,$3.23,$0.00,$3965.86,Print
5/27/2020,$2.84,$0.00,$3963.02,Print
5/27/2020,$3.25,$0.00,$3959.77,Print
5/27/2020,$2.74,$0.00,$3957.03,Print
5/27/2020,$2.78,$0.00,$3954.25,Print
5/27/2020,$2.84,$0.00,$3951.41,Print
5/27/2020,$3.23,$0.00,$3948.18,Print
5/27/2020,$2.78,$0.00,$3945.40,Print
5/27/2020,$2.84,$0.00,$3942.56,Print
5/27/2020,$3.31,$0.00,$3939.25,Print
5/27/2020,$2.78,$0.00,$3936.47,Print
5/27/2020,$2.78,$0.00,$3933.69,Print
5/27/2020,$3.97,$0.00,$3929.72,Print
5/27/2020,$3.23,$0.00,$3926.49,Print
5/27/2020,$3.39,$0.00,$3923.10,Print
5/27/2020,$4.08,$0.00,$3919.02,Print
5/27/2020,$2.78,$0.00,$3916.24,Print
5/27/2020,$2.84,$0.00,$3913.40,Print
5/27/2020,$8.12,$0.00,$3905.28,Print
5/27/2020,$3.31,$0.00,$3901.97,Print
5/27/2020,$3.31,$0.00,$3898.66,Print
5/27/2020,$3.25,$0.00,$3895.41,Print
5/27/2020,$3.52,$0.00,$3891.89,Print
5/27/2020,$2.84,$0.00,$3889.05,Print
5/27/2020,$3.21,$0.00,$3885.84,Print
5/27/2020,$3.31,$0.00,$3882.53,Print
5/27/2020,$2.74,$0.00,$3879.79,Print
5/27/2020,$3.23,$0.00,$3876.56,Print
5/27/2020,$2.78,$0.00,$3873.78,Print
5/27/2020,$2.84,$0.00,$3870.94,Print
5/27/2020,$3.31,$0.00,$3867.63,Print
5/27/2020,$2.78,$0.00,$3864.85,Print
5/27/2020,$3.31,$0.00,$3861.54,Print
5/27/2020,$2.78,$0.00,$3858.76,Print
5/27/2020,$2.78,$0.00,$3855.98,Print
5/27/2020,$2.78,$0.00,$3853.20,Print
5/27/2020,$2.78,$0.00,$3850.42,Print
5/27/2020,$2.74,$0.00,$3847.68,Print
5/27/2020,$3.05,$0.00,$3844.63,Print
5/27/2020,$3.05,$0.00,$3841.58,Print
5/27/2020,$2.78,$0.00,$3838.80,Print
5/27/2020,$3.25,$0.00,$3835.55,Print
5/27/2020,$2.84,$0.00,$3832.71,Print
5/27/2020,$3.21,$0.00,$3829.50,Print
5/27/2020,$2.74,$0.00,$3826.76,Print
5/27/2020,$2.74,$0.00,$3824.02,Print
5/27/2020,$2.84,$0.00,$3821.18,Print
5/27/2020,$3.31,$0.00,$3817.87,Print
5/27/2020,$2.84,$0.00,$3815.03,Print
5/27/2020,$2.84,$0.00,$3812.19,Print
5/27/2020,$2.74,$0.00,$3809.45,Print
5/27/2020,$2.74,$0.00,$3806.71,Print
5/27/2020,$2.74,$0.00,$3803.97,Print
5/27/2020,$12.15,$0.00,$3791.82,Print
5/27/2020,$2.84,$0.00,$3788.98,Print
5/27/2020,$3.23,$0.00,$3785.75,Print
5/27/2020,$2.93,$0.00,$3782.82,Print
5/27/2020,$15.74,$0.00,$3767.08,Print
5/27/2020,$2.84,$0.00,$3764.24,Print
5/27/2020,$3.25,$0.00,$3760.99,Print
5/27/2020,$3.21,$0.00,$3757.78,Print
5/27/2020,$5.40,$0.00,$3752.38,Print
5/27/2020,$3.25,$0.00,$3749.13,Print
5/27/2020,$3.05,$0.00,$3746.08,Print
5/27/2020,$2.78,$0.00,$3743.30,Print
5/27/2020,$2.84,$0.00,$3740.46,Print
5/27/2020,$3.21,$0.00,$3737.25,Print
5/27/2020,$3.25,$0.00,$3734.00,Print
5/27/2020,$3.25,$0.00,$3730.75,Print
5/27/2020,$2.84,$0.00,$3727.91,Print
5/27/2020,$3.25,$0.00,$3724.66,Print
5/27/2020,$2.78,$0.00,$3721.88,Print
5/27/2020,$3.31,$0.00,$3718.57,Print
5/27/2020,$3.21,$0.00,$3715.36,Print
5/27/2020,$3.31,$0.00,$3712.05,Print
5/27/2020,$2.78,$0.00,$3709.27,Print
5/27/2020,$3.25,$0.00,$3706.02,Print
5/27/2020,$3.21,$0.00,$3702.81,Print
5/27/2020,$4.08,$0.00,$3698.73,Print
5/27/2020,$11.19,$0.00,$3687.54,Print
5/27/2020,$3.31,$0.00,$3684.23,Print
5/27/2020,$3.21,$0.00,$3681.02,Print
5/27/2020,$11.19,$0.00,$3669.83,Print
5/27/2020,$11.19,$0.00,$3658.64,Print
5/27/2020,$3.18,$0.00,$3655.46,Print
5/27/2020,$4.00,$0.00,$3651.46,Print
5/27/2020,$2.78,$0.00,$3648.68,Print
5/27/2020,$3.31,$0.00,$3645.37,Print
5/27/2020,$5.27,$0.00,$3640.10,Print
5/27/2020,$3.67,$0.00,$3636.43,Print
5/27/2020,$3.52,$0.00,$3632.91,Print
5/27/2020,$3.25,$0.00,$3629.66,Print
5/27/2020,$4.32,$0.00,$3625.34,Print
5/27/2020,$3.39,$0.00,$3621.95,Print
5/27/2020,$3.25,$0.00,$3618.70,Print
5/27/2020,$3.52,$0.00,$3615.18,Print
5/27/2020,$3.52,$0.00,$3611.66,Print
5/27/2020,$3.25,$0.00,$3608.41,Print
5/27/2020,$4.00,$0.00,$3604.41,Print
5/27/2020,$3.31,$0.00,$3601.10,Print
5/27/2020,$3.31,$0.00,$3597.79,Print
5/27/2020,$3.25,$0.00,$3594.54,Print
5/27/2020,$3.93,$0.00,$3590.61,Print
5/27/2020,$4.08,$0.00,$3586.53,Print
5/27/2020,$4.32,$0.00,$3582.21,Print
5/27/2020,$3.21,$0.00,$3579.00,Print
5/27/2020,$3.25,$0.00,$3575.75,Print
5/27/2020,$4.00,$0.00,$3571.75,Print
5/27/2020,$3.31,$0.00,$3568.44,Print
5/27/2020,$4.08,$0.00,$3564.36,Print
5/27/2020,$3.25,$0.00,$3561.11,Print
5/27/2020,$4.00,$0.00,$3557.11,Print
5/27/2020,$4.00,$0.00,$3553.11,Print
5/27/2020,$3.21,$0.00,$3549.90,Print
5/27/2020,$3.52,$0.00,$3546.38,Print
5/27/2020,$3.31,$0.00,$3543.07,Print
5/27/2020,$3.31,$0.00,$3539.76,Print
5/27/2020,$3.23,$0.00,$3536.53,Print
5/27/2020,$3.25,$0.00,$3533.28,Print
5/27/2020,$2.84,$0.00,$3530.44,Print
5/27/2020,$3.25,$0.00,$3527.19,Print
5/27/2020,$2.74,$0.00,$3524.45,Print
5/27/2020,$4.00,$0.00,$3520.45,Print
5/27/2020,$3.25,$0.00,$3517.20,Print
5/27/2020,$2.78,$0.00,$3514.42,Print
5/27/2020,$3.31,$0.00,$3511.11,Print
5/27/2020,$3.93,$0.00,$3507.18,Print
5/27/2020,$2.74,$0.00,$3504.44,Print
5/27/2020,$4.32,$0.00,$3500.12,Print
5/27/2020,$2.78,$0.00,$3497.34,Print
5/27/2020,$5.08,$0.00,$3492.26,Print
5/27/2020,$4.08,$0.00,$3488.18,Print
5/27/2020,$2.78,$0.00,$3485.40,Print
5/27/2020,$5.54,$0.00,$3479.86,Print
5/27/2020,$2.78,$0.00,$3477.08,Print
5/27/2020,$3.52,$0.00,$3473.56,Print
5/27/2020,$4.08,$0.00,$3469.48,Print
5/27/2020,$39.69,$0.00,$3429.79,Print
5/27/2020,$4.08,$0.00,$3425.71,Print
5/27/2020,$3.25,$0.00,$3422.46,Print
5/27/2020,$3.25,$0.00,$3419.21,Print
5/27/2020,$3.31,$0.00,$3415.90,Print
5/27/2020,$2.78,$0.00,$3413.12,Print
5/27/2020,$2.78,$0.00,$3410.34,Print
5/27/2020,$3.39,$0.00,$3406.95,Print
5/27/2020,$3.52,$0.00,$3403.43,Print
5/27/2020,$3.21,$0.00,$3400.22,Print
5/27/2020,$3.31,$0.00,$3396.91,Print
5/27/2020,$3.31,$0.00,$3393.60,Print
5/27/2020,$3.25,$0.00,$3390.35,Print
5/27/2020,$3.52,$0.00,$3386.83,Print
5/27/2020,$2.84,$0.00,$3383.99,Print
5/27/2020,$4.00,$0.00,$3379.99,Print
5/27/2020,$2.74,$0.00,$3377.25,Print
5/27/2020,$2.78,$0.00,$3374.47,Print
5/27/2020,$2.74,$0.00,$3371.73,Print
5/27/2020,$2.74,$0.00,$3368.99,Print
5/27/2020,$3.05,$0.00,$3365.94,Print
5/27/2020,$2.84,$0.00,$3363.10,Print
5/27/2020,$3.25,$0.00,$3359.85,Print
5/27/2020,$3.21,$0.00,$3356.64,Print
5/27/2020,$2.74,$0.00,$3353.90,Print
5/27/2020,$2.84,$0.00,$3351.06,Print
5/27/2020,$4.00,$0.00,$3347.06,Print
5/27/2020,$4.32,$0.00,$3342.74,Print
5/27/2020,$4.00,$0.00,$3338.74,Print
5/27/2020,$2.74,$0.00,$3336.00,Print
5/27/2020,$2.76,$0.00,$3333.24,Print
5/27/2020,$3.31,$0.00,$3329.93,Print
5/27/2020,$3.25,$0.00,$3326.68,Print
5/27/2020,$3.31,$0.00,$3323.37,Print
5/27/2020,$4.32,$0.00,$3319.05,Print
5/27/2020,$3.23,$0.00,$3315.82,Print
5/27/2020,$2.84,$0.00,$3312.98,Print
5/27/2020,$3.39,$0.00,$3309.59,Print
5/27/2020,$3.05,$0.00,$3306.54,Print
5/27/2020,$2.78,$0.00,$3303.76,Print
5/27/2020,$2.74,$0.00,$3301.02,Print
5/27/2020,$3.39,$0.00,$3297.63,Print
5/27/2020,$3.25,$0.00,$3294.38,Print
5/27/2020,$3.52,$0.00,$3290.86,Print
5/27/2020,$4.00,$0.00,$3286.86,Print
5/27/2020,$4.08,$0.00,$3282.78,Print
5/27/2020,$4.08,$0.00,$3278.70,Print
5/27/2020,$2.84,$0.00,$3275.86,Print
5/27/2020,$3.21,$0.00,$3272.65,Print
5/27/2020,$3.52,$0.00,$3269.13,Print
5/27/2020,$2.74,$0.00,$3266.39,Print
5/27/2020,$3.21,$0.00,$3263.18,Print
5/27/2020,$4.00,$0.00,$3259.18,Print
5/27/2020,$4.00,$0.00,$3255.18,Print
5/27/2020,$4.00,$0.00,$3251.18,Print
5/27/2020,$2.78,$0.00,$3248.40,Print
5/27/2020,$2.84,$0.00,$3245.56,Print
5/27/2020,$4.18,$0.00,$3241.38,Print
5/27/2020,$4.00,$0.00,$3237.38,Print
5/27/2020,$2.76,$0.00,$3234.62,Print
5/27/2020,$3.93,$0.00,$3230.69,Print
5/27/2020,$3.93,$0.00,$3226.76,Print
5/27/2020,$2.84,$0.00,$3223.92,Print
5/27/2020,$3.21,$0.00,$3220.71,Print
5/27/2020,$3.25,$0.00,$3217.46,Print
5/27/2020,$2.78,$0.00,$3214.68,Print
5/27/2020,$3.25,$0.00,$3211.43,Print
5/27/2020,$3.31,$0.00,$3208.12,Print
5/27/2020,$3.25,$0.00,$3204.87,Print
5/27/2020,$2.78,$0.00,$3202.09,Print
5/27/2020,$3.25,$0.00,$3198.84,Print
5/27/2020,$4.32,$0.00,$3194.52,Print
5/27/2020,$4.00,$0.00,$3190.52,Print
5/27/2020,$2.74,$0.00,$3187.78,Print
5/27/2020,$2.76,$0.00,$3185.02,Print
5/27/2020,$3.05,$0.00,$3181.97,Print
5/27/2020,$3.31,$0.00,$3178.66,Print
5/27/2020,$2.74,$0.00,$3175.92,Print
5/27/2020,$4.32,$0.00,$3171.60,Print
5/27/2020,$3.25,$0.00,$3168.35,Print
5/27/2020,$3.21,$0.00,$3165.14,Print
5/27/2020,$3.25,$0.00,$3161.89,Print
5/27/2020,$4.00,$0.00,$3157.89,Print
5/27/2020,$3.21,$0.00,$3154.68,Print
5/27/2020,$3.25,$0.00,$3151.43,Print
5/27/2020,$3.21,$0.00,$3148.22,Print
5/27/2020,$3.21,$0.00,$3145.01,Print
5/27/2020,$2.78,$0.00,$3142.23,Print
5/27/2020,$3.25,$0.00,$3138.98,Print
5/27/2020,$2.93,$0.00,$3136.05,Print
5/27/2020,$3.31,$0.00,$3132.74,Print
5/27/2020,$2.78,$0.00,$3129.96,Print
5/27/2020,$2.78,$0.00,$3127.18,Print
5/27/2020,$2.78,$0.00,$3124.40,Print
5/27/2020,$3.25,$0.00,$3121.15,Print
5/27/2020,$3.25,$0.00,$3117.90,Print
5/27/2020,$2.78,$0.00,$3115.12,Print
5/27/2020,$3.31,$0.00,$3111.81,Print
5/27/2020,$3.52,$0.00,$3108.29,Print
5/27/2020,$3.25,$0.00,$3105.04,Print
5/27/2020,$2.74,$0.00,$3102.30,Print
5/27/2020,$3.52,$0.00,$3098.78,Print
5/27/2020,$3.25,$0.00,$3095.53,Print
5/27/2020,$3.05,$0.00,$3092.48,Print
5/27/2020,$2.78,$0.00,$3089.70,Print
5/27/2020,$2.78,$0.00,$3086.92,Print
5/27/2020,$3.05,$0.00,$3083.87,Print
5/27/2020,$2.78,$0.00,$3081.09,Print
5/27/2020,$3.05,$0.00,$3078.04,Print
5/27/2020,$2.84,$0.00,$3075.20,Print
5/27/2020,$3.05,$0.00,$3072.15,Print
5/27/2020,$2.76,$0.00,$3069.39,Print
5/27/2020,$2.78,$0.00,$3066.61,Print
5/27/2020,$2.84,$0.00,$3063.77,Print
5/27/2020,$3.25,$0.00,$3060.52,Print
5/27/2020,$3.25,$0.00,$3057.27,Print
5/27/2020,$3.39,$0.00,$3053.88,Print
5/27/2020,$4.00,$0.00,$3049.88,Print
5/27/2020,$3.52,$0.00,$3046.36,Print
5/27/2020,$3.05,$0.00,$3043.31,Print
5/27/2020,$3.21,$0.00,$3040.10,Print
5/27/2020,$2.93,$0.00,$3037.17,Print
5/27/2020,$2.84,$0.00,$3034.33,Print
5/27/2020,$3.25,$0.00,$3031.08,Print
5/27/2020,$3.25,$0.00,$3027.83,Print
5/27/2020,$3.52,$0.00,$3024.31,Print
5/27/2020,$3.31,$0.00,$3021.00,Print
5/27/2020,$3.21,$0.00,$3017.79,Print
5/27/2020,$2.74,$0.00,$3015.05,Print
5/27/2020,$3.05,$0.00,$3012.00,Print
5/27/2020,$2.74,$0.00,$3009.26,Print
5/27/2020,$2.78,$0.00,$3006.48,Print
5/27/2020,$2.78,$0.00,$3003.70,Print
5/27/2020,$3.25,$0.00,$3000.45,Print
5/27/2020,$3.25,$0.00,$2997.20,Print
5/27/2020,$3.25,$0.00,$2993.95,Print
5/27/2020,$3.25,$0.00,$2990.70,Print
5/27/2020,$4.08,$0.00,$2986.62,Print
5/27/2020,$3.21,$0.00,$2983.41,Print
5/27/2020,$3.25,$0.00,$2980.16,Print
5/27/2020,$3.52,$0.00,$2976.64,Print
5/27/2020,$3.21,$0.00,$2973.43,Print
5/27/2020,$2.76,$0.00,$2970.67,Print
5/27/2020,$4.32,$0.00,$2966.35,Print
5/27/2020,$3.25,$0.00,$2963.10,Print
5/27/2020,$3.25,$0.00,$2959.85,Print
5/27/2020,$2.84,$0.00,$2957.01,Print
5/27/2020,$3.25,$0.00,$2953.76,Print
5/27/2020,$69.36,$0.00,$2884.40,Print
5/27/2020,$2.76,$0.00,$2881.64,Print
5/27/2020,$2.78,$0.00,$2878.86,Print
5/27/2020,$2.78,$0.00,$2876.08,Print
5/27/2020,$2.84,$0.00,$2873.24,Print
5/27/2020,$2.78,$0.00,$2870.46,Print
5/27/2020,$2.78,$0.00,$2867.68,Print
5/27/2020,$2.84,$0.00,$2864.84,Print
5/27/2020,$2.84,$0.00,$2862.00,Print
5/27/2020,$2.78,$0.00,$2859.22,Print
5/27/2020,$2.76,$0.00,$2856.46,Print
5/27/2020,$2.78,$0.00,$2853.68,Print
5/27/2020,$2.84,$0.00,$2850.84,Print
5/27/2020,$2.84,$0.00,$2848.00,Print
5/27/2020,$2.84,$0.00,$2845.16,Print
5/27/2020,$2.84,$0.00,$2842.32,Print
5/27/2020,$2.76,$0.00,$2839.56,Print
5/27/2020,$2.84,$0.00,$2836.72,Print
5/27/2020,$2.84,$0.00,$2833.88,Print
5/27/2020,$2.78,$0.00,$2831.10,Print
5/27/2020,$2.78,$0.00,$2828.32,Print
5/27/2020,$2.93,$0.00,$2825.39,Print
5/27/2020,$2.76,$0.00,$2822.63,Print
5/27/2020,$2.84,$0.00,$2819.79,Print
5/27/2020,$2.78,$0.00,$2817.01,Print
5/27/2020,$2.84,$0.00,$2814.17,Print
5/27/2020,$2.84,$0.00,$2811.33,Print
5/27/2020,$2.84,$0.00,$2808.49,Print
5/27/2020,$2.93,$0.00,$2805.56,Print
5/27/2020,$2.78,$0.00,$2802.78,Print
5/27/2020,$2.76,$0.00,$2800.02,Print
5/27/2020,$2.84,$0.00,$2797.18,Print
5/27/2020,$2.84,$0.00,$2794.34,Print
5/27/2020,$2.84,$0.00,$2791.50,Print
5/27/2020,$3.23,$0.00,$2788.27,Print
5/27/2020,$3.31,$0.00,$2784.96,Print
5/27/2020,$2.84,$0.00,$2782.12,Print
5/27/2020,$2.76,$0.00,$2779.36,Print
5/27/2020,$2.76,$0.00,$2776.60,Print
5/27/2020,$2.78,$0.00,$2773.82,Print
5/27/2020,$2.84,$0.00,$2770.98,Print
5/27/2020,$2.76,$0.00,$2768.22,Print
5/27/2020,$2.78,$0.00,$2765.44,Print
5/27/2020,$2.84,$0.00,$2762.60,Print
5/27/2020,$2.84,$0.00,$2759.76,Print
5/27/2020,$2.76,$0.00,$2757.00,Print
5/27/2020,$2.76,$0.00,$2754.24,Print
5/27/2020,$2.74,$0.00,$2751.50,Print
5/27/2020,$2.84,$0.00,$2748.66,Print
5/27/2020,$2.78,$0.00,$2745.88,Print
5/27/2020,$2.74,$0.00,$2743.14,Print
5/27/2020,$2.78,$0.00,$2740.36,Print
5/27/2020,$2.78,$0.00,$2737.58,Print
5/27/2020,$2.78,$0.00,$2734.80,Print
5/27/2020,$3.05,$0.00,$2731.75,Print
5/27/2020,$2.78,$0.00,$2728.97,Print
5/27/2020,$2.78,$0.00,$2726.19,Print
5/27/2020,$2.78,$0.00,$2723.41,Print
5/27/2020,$3.05,$0.00,$2720.36,Print
5/27/2020,$2.84,$0.00,$2717.52,Print
5/27/2020,$2.76,$0.00,$2714.76,Print
5/27/2020,$3.31,$0.00,$2711.45,Print
5/27/2020,$2.84,$0.00,$2708.61,Print
5/27/2020,$2.78,$0.00,$2705.83,Print
5/27/2020,$2.84,$0.00,$2702.99,Print
5/27/2020,$3.05,$0.00,$2699.94,Print
5/27/2020,$2.78,$0.00,$2697.16,Print
5/27/2020,$2.84,$0.00,$2694.32,Print
5/27/2020,$2.78,$0.00,$2691.54,Print
5/27/2020,$2.84,$0.00,$2688.70,Print
5/27/2020,$2.74,$0.00,$2685.96,Print
5/27/2020,$2.76,$0.00,$2683.20,Print
5/27/2020,$2.84,$0.00,$2680.36,Print
5/27/2020,$2.84,$0.00,$2677.52,Print
5/27/2020,$2.78,$0.00,$2674.74,Print
5/27/2020,$2.78,$0.00,$2671.96,Print
5/27/2020,$2.76,$0.00,$2669.20,Print
5/27/2020,$2.84,$0.00,$2666.36,Print
5/27/2020,$2.93,$0.00,$2663.43,Print
5/27/2020,$5.12,$0.00,$2658.31,Print
5/27/2020,$2.84,$0.00,$2655.47,Print
5/27/2020,$2.84,$0.00,$2652.63,Print
5/27/2020,$2.84,$0.00,$2649.79,Print
5/27/2020,$2.78,$0.00,$2647.01,Print
5/27/2020,$2.78,$0.00,$2644.23,Print
5/27/2020,$2.84,$0.00,$2641.39,Print
5/27/2020,$2.84,$0.00,$2638.55,Print
5/27/2020,$2.84,$0.00,$2635.71,Print
5/27/2020,$2.78,$0.00,$2632.93,Print
5/27/2020,$2.84,$0.00,$2630.09,Print
5/27/2020,$3.18,$0.00,$2626.91,Print
5/27/2020,$2.78,$0.00,$2624.13,Print
5/27/2020,$3.67,$0.00,$2620.46,Print
5/27/2020,$2.76,$0.00,$2617.70,Print
5/27/2020,$2.84,$0.00,$2614.86,Print
5/27/2020,$3.31,$0.00,$2611.55,Print
5/27/2020,$3.31,$0.00,$2608.24,Print
5/27/2020,$2.76,$0.00,$2605.48,Print
5/27/2020,$2.78,$0.00,$2602.70,Print
5/27/2020,$3.23,$0.00,$2599.47,Print
5/27/2020,$3.25,$0.00,$2596.22,Print
5/27/2020,$3.31,$0.00,$2592.91,Print
5/27/2020,$2.74,$0.00,$2590.17,Print
5/27/2020,$2.84,$0.00,$2587.33,Print
5/27/2020,$3.23,$0.00,$2584.10,Print
5/27/2020,$3.25,$0.00,$2580.85,Print
5/27/2020,$3.25,$0.00,$2577.60,Print
5/27/2020,$3.25,$0.00,$2574.35,Print
5/27/2020,$3.39,$0.00,$2570.96,Print
5/27/2020,$3.67,$0.00,$2567.29,Print
5/27/2020,$3.67,$0.00,$2563.62,Print
5/27/2020,$2.76,$0.00,$2560.86,Print
5/27/2020,$2.78,$0.00,$2558.08,Print
5/27/2020,$4.00,$0.00,$2554.08,Print
5/27/2020,$4.18,$0.00,$2549.90,Print
5/27/2020,$4.18,$0.00,$2545.72,Print
5/27/2020,$4.46,$0.00,$2541.26,Print
5/27/2020,$4.08,$0.00,$2537.18,Print
5/27/2020,$4.08,$0.00,$2533.10,Print
5/27/2020,$4.08,$0.00,$2529.02,Print
5/27/2020,$2.78,$0.00,$2526.24,Print
5/27/2020,$2.78,$0.00,$2523.46,Print
5/27/2020,$2.84,$0.00,$2520.62,Print
5/27/2020,$18.14,$0.00,$2502.48,Print
5/27/2020,$3.25,$0.00,$2499.23,Print
5/27/2020,$2000.00,$0.00,$4499.23,Purchase
5/27/2020,$5.12,$0.00,$4494.11,Print
5/27/2020,$3.21,$0.00,$4490.90,Print
5/27/2020,$2.78,$0.00,$4488.12,Print
5/27/2020,$2.76,$0.00,$4485.36,Print
5/27/2020,$2.78,$0.00,$4482.58,Print
5/27/2020,$2.76,$0.00,$4479.82,Print
5/27/2020,$2.74,$0.00,$4477.08,Print
5/27/2020,$3.25,$0.00,$4473.83,Print
5/27/2020,$3.97,$0.00,$4469.86,Print
5/27/2020,$4.00,$0.00,$4465.86,Print
5/27/2020,$3.25,$0.00,$4462.61,Print
5/27/2020,$3.25,$0.00,$4459.36,Print
5/27/2020,$5.27,$0.00,$4454.09,Print
5/27/2020,$2.76,$0.00,$4451.33,Print
5/27/2020,$5.27,$0.00,$4446.06,Print
5/27/2020,$5.12,$0.00,$4440.94,Print
5/27/2020,$2.74,$0.00,$4438.20,Print
5/27/2020,$2.84,$0.00,$4435.36,Print
5/27/2020,$2.84,$0.00,$4432.52,Print
5/27/2020,$2.74,$0.00,$4429.78,Print
5/27/2020,$2.93,$0.00,$4426.85,Print
5/27/2020,$2.76,$0.00,$4424.09,Print
5/27/2020,$2.74,$0.00,$4421.35,Print
5/27/2020,$2.78,$0.00,$4418.57,Print
5/27/2020,$2.84,$0.00,$4415.73,Print
5/27/2020,$2.93,$0.00,$4412.80,Print
5/27/2020,$3.23,$0.00,$4409.57,Print
5/27/2020,$2.84,$0.00,$4406.73,Print
5/27/2020,$2.84,$0.00,$4403.89,Print
5/27/2020,$2.78,$0.00,$4401.11,Print
5/27/2020,$2.84,$0.00,$4398.27,Print
5/27/2020,$2.84,$0.00,$4395.43,Print
5/27/2020,$2.84,$0.00,$4392.59,Print
5/27/2020,$2.84,$0.00,$4389.75,Print
5/27/2020,$2.84,$0.00,$4386.91,Print
5/27/2020,$2.76,$0.00,$4384.15,Print
5/27/2020,$2.78,$0.00,$4381.37,Print
5/27/2020,$2.78,$0.00,$4378.59,Print
5/27/2020,$2.74,$0.00,$4375.85,Print
5/27/2020,$2.84,$0.00,$4373.01,Print
5/28/2020,$2.84,$0.00,$4370.17,Print
5/28/2020,$2.84,$0.00,$4367.33,Print
5/28/2020,$2.84,$0.00,$4364.49,Print
5/28/2020,$4.32,$0.00,$4360.17,Print
5/28/2020,$3.23,$0.00,$4356.94,Print
5/28/2020,$3.31,$0.00,$4353.63,Print
5/28/2020,$2.74,$0.00,$4350.89,Print
5/28/2020,$2.76,$0.00,$4348.13,Print
5/28/2020,$2.84,$0.00,$4345.29,Print
5/28/2020,$2.84,$0.00,$4342.45,Print
5/28/2020,$2.78,$0.00,$4339.67,Print
5/28/2020,$2.78,$0.00,$4336.89,Print
5/28/2020,$2.78,$0.00,$4334.11,Print
5/28/2020,$2.84,$0.00,$4331.27,Print
5/28/2020,$2.84,$0.00,$4328.43,Print
5/28/2020,$2.84,$0.00,$4325.59,Print
5/28/2020,$2.84,$0.00,$4322.75,Print
5/28/2020,$2.84,$0.00,$4319.91,Print
5/28/2020,$2.84,$0.00,$4317.07,Print
5/28/2020,$2.78,$0.00,$4314.29,Print
5/28/2020,$2.78,$0.00,$4311.51,Print
5/28/2020,$7.80,$0.00,$4303.71,Print
5/28/2020,$2.84,$0.00,$4300.87,Print
5/28/2020,$2.84,$0.00,$4298.03,Print
5/28/2020,$2.74,$0.00,$4295.29,Print
5/28/2020,$2.84,$0.00,$4292.45,Print
5/28/2020,$2.84,$0.00,$4289.61,Print
5/28/2020,$2.74,$0.00,$4286.87,Print
5/28/2020,$2.78,$0.00,$4284.09,Print
5/28/2020,$2.84,$0.00,$4281.25,Print
5/28/2020,$2.78,$0.00,$4278.47,Print
5/28/2020,$2.76,$0.00,$4275.71,Print
5/28/2020,$2.78,$0.00,$4272.93,Print
5/28/2020,$2.93,$0.00,$4270.00,Print
5/28/2020,$2.74,$0.00,$4267.26,Print
5/28/2020,$2.76,$0.00,$4264.50,Print
5/28/2020,$2.84,$0.00,$4261.66,Print
5/28/2020,$2.84,$0.00,$4258.82,Print
5/28/2020,$2.84,$0.00,$4255.98,Print
5/28/2020,$2.74,$0.00,$4253.24,Print
5/28/2020,$3.21,$0.00,$4250.03,Print
5/28/2020,$3.21,$0.00,$4246.82,Print
5/28/2020,$5.04,$0.00,$4241.78,Print
5/28/2020,$3.21,$0.00,$4238.57,Print
5/28/2020,$2.74,$0.00,$4235.83,Print
5/28/2020,$3.93,$0.00,$4231.90,Print
5/28/2020,$5.08,$0.00,$4226.82,Print
5/28/2020,$3.23,$0.00,$4223.59,Print
5/28/2020,$3.25,$0.00,$4220.34,Print
5/28/2020,$3.21,$0.00,$4217.13,Print
5/28/2020,$3.25,$0.00,$4213.88,Print
5/28/2020,$3.23,$0.00,$4210.65,Print
5/28/2020,$3.23,$0.00,$4207.42,Print
5/28/2020,$2.76,$0.00,$4204.66,Print
5/28/2020,$7.35,$0.00,$4197.31,Print
5/28/2020,$2.76,$0.00,$4194.55,Print
5/28/2020,$3.23,$0.00,$4191.32,Print
5/28/2020,$3.21,$0.00,$4188.11,Print
5/28/2020,$2.76,$0.00,$4185.35,Print
5/28/2020,$3.21,$0.00,$4182.14,Print
5/28/2020,$3.25,$0.00,$4178.89,Print
5/28/2020,$2.78,$0.00,$4176.11,Print
5/28/2020,$2.84,$0.00,$4173.27,Print
5/28/2020,$2.76,$0.00,$4170.51,Print
5/28/2020,$2.74,$0.00,$4167.77,Print
5/28/2020,$2.74,$0.00,$4165.03,Print
5/28/2020,$2.76,$0.00,$4162.27,Print
5/28/2020,$2.76,$0.00,$4159.51,Print
5/28/2020,$2.74,$0.00,$4156.77,Print
5/28/2020,$3.25,$0.00,$4153.52,Print
5/28/2020,$2.76,$0.00,$4150.76,Print
5/28/2020,$5.04,$0.00,$4145.72,Print
5/28/2020,$2.93,$0.00,$4142.79,Print
5/28/2020,$3.23,$0.00,$4139.56,Print
5/28/2020,$2.74,$0.00,$4136.82,Print
5/28/2020,$3.21,$0.00,$4133.61,Print
5/28/2020,$2.74,$0.00,$4130.87,Print
5/28/2020,$2.74,$0.00,$4128.13,Print
5/28/2020,$2.78,$0.00,$4125.35,Print
5/28/2020,$3.25,$0.00,$4122.10,Print
5/28/2020,$2.74,$0.00,$4119.36,Print
5/28/2020,$3.25,$0.00,$4116.11,Print
5/28/2020,$2.78,$0.00,$4113.33,Print
5/28/2020,$3.21,$0.00,$4110.12,Print
5/28/2020,$2.76,$0.00,$4107.36,Print
5/28/2020,$2.78,$0.00,$4104.58,Print
5/28/2020,$3.21,$0.00,$4101.37,Print
5/28/2020,$3.21,$0.00,$4098.16,Print
5/28/2020,$3.21,$0.00,$4094.95,Print
5/28/2020,$3.23,$0.00,$4091.72,Print
5/28/2020,$3.23,$0.00,$4088.49,Print
5/28/2020,$2.76,$0.00,$4085.73,Print
5/28/2020,$3.25,$0.00,$4082.48,Print
5/28/2020,$3.21,$0.00,$4079.27,Print
5/28/2020,$2.84,$0.00,$4076.43,Print
5/28/2020,$2.74,$0.00,$4073.69,Print
5/28/2020,$2.84,$0.00,$4070.85,Print
5/28/2020,$3.21,$0.00,$4067.64,Print
5/28/2020,$3.23,$0.00,$4064.41,Print
5/28/2020,$3.25,$0.00,$4061.16,Print
5/28/2020,$3.21,$0.00,$4057.95,Print
5/28/2020,$3.21,$0.00,$4054.74,Print
5/28/2020,$2.78,$0.00,$4051.96,Print
5/28/2020,$3.97,$0.00,$4047.99,Print
5/28/2020,$3.25,$0.00,$4044.74,Print
5/28/2020,$3.21,$0.00,$4041.53,Print
5/28/2020,$2.84,$0.00,$4038.69,Print
5/28/2020,$3.25,$0.00,$4035.44,Print
5/28/2020,$3.23,$0.00,$4032.21,Print
5/28/2020,$3.21,$0.00,$4029.00,Print
5/28/2020,$2.78,$0.00,$4026.22,Print
5/28/2020,$3.31,$0.00,$4022.91,Print
5/28/2020,$3.31,$0.00,$4019.60,Print
5/28/2020,$3.21,$0.00,$4016.39,Print
5/28/2020,$2.84,$0.00,$4013.55,Print
5/28/2020,$2.93,$0.00,$4010.62,Print
5/28/2020,$3.23,$0.00,$4007.39,Print
5/28/2020,$3.31,$0.00,$4004.08,Print
5/28/2020,$3.23,$0.00,$4000.85,Print
5/28/2020,$2.84,$0.00,$3998.01,Print
5/28/2020,$1.28,$0.00,$3996.73,Adjustment
5/28/2020,$3.25,$0.00,$3993.48,Print
5/28/2020,$2.76,$0.00,$3990.72,Print
5/28/2020,$2.84,$0.00,$3987.88,Print
5/28/2020,$2.76,$0.00,$3985.12,Print
5/28/2020,$8.23,$0.00,$3976.89,Print
5/28/2020,$5.12,$0.00,$3971.77,Print
5/28/2020,$5.70,$0.00,$3966.07,Print
5/28/2020,$3.21,$0.00,$3962.86,Print
5/28/2020,$5.12,$0.00,$3957.74,Print
5/28/2020,$2.93,$0.00,$3954.81,Print
5/28/2020,$5.12,$0.00,$3949.69,Print
5/28/2020,$5.54,$0.00,$3944.15,Print
5/28/2020,$5.54,$0.00,$3938.61,Print
5/28/2020,$2.84,$0.00,$3935.77,Print
5/28/2020,$2.84,$0.00,$3932.93,Print
5/28/2020,$2.84,$0.00,$3930.09,Print
5/28/2020,$2.93,$0.00,$3927.16,Print
5/28/2020,$3.21,$0.00,$3923.95,Print
5/28/2020,$4.08,$0.00,$3919.87,Print
5/28/2020,$4.08,$0.00,$3915.79,Print
5/28/2020,$3.25,$0.00,$3912.54,Print
5/28/2020,$3.21,$0.00,$3909.33,Print
5/28/2020,$3.25,$0.00,$3906.08,Print
5/28/2020,$3.52,$0.00,$3902.56,Print
5/28/2020,$2.78,$0.00,$3899.78,Print
5/28/2020,$3.21,$0.00,$3896.57,Print
5/28/2020,$2.76,$0.00,$3893.81,Print
5/28/2020,$3.31,$0.00,$3890.50,Print
5/28/2020,$2.78,$0.00,$3887.72,Print
5/28/2020,$3.31,$0.00,$3884.41,Print
5/28/2020,$3.52,$0.00,$3880.89,Print
5/28/2020,$3.05,$0.00,$3877.84,Print
5/28/2020,$3.25,$0.00,$3874.59,Print
5/28/2020,$3.21,$0.00,$3871.38,Print
5/28/2020,$3.25,$0.00,$3868.13,Print
5/28/2020,$3.25,$0.00,$3864.88,Print
5/28/2020,$3.25,$0.00,$3861.63,Print
5/28/2020,$3.31,$0.00,$3858.32,Print
5/28/2020,$3.21,$0.00,$3855.11,Print
5/28/2020,$4.08,$0.00,$3851.03,Print
5/28/2020,$4.00,$0.00,$3847.03,Print
5/28/2020,$4.08,$0.00,$3842.95,Print
5/28/2020,$5.12,$0.00,$3837.83,Print
5/28/2020,$5.40,$0.00,$3832.43,Print
5/28/2020,$3.21,$0.00,$3829.22,Print
5/28/2020,$3.31,$0.00,$3825.91,Print
5/28/2020,$3.25,$0.00,$3822.66,Print
5/28/2020,$3.97,$0.00,$3818.69,Print
5/28/2020,$4.00,$0.00,$3814.69,Print
5/28/2020,$3.31,$0.00,$3811.38,Print
5/28/2020,$4.08,$0.00,$3807.30,Print
5/28/2020,$3.23,$0.00,$3804.07,Print
5/28/2020,$4.08,$0.00,$3799.99,Print
5/28/2020,$2.78,$0.00,$3797.21,Print
5/28/2020,$4.00,$0.00,$3793.21,Print
5/28/2020,$5.12,$0.00,$3788.09,Print
5/28/2020,$4.00,$0.00,$3784.09,Print
5/28/2020,$3.25,$0.00,$3780.84,Print
5/28/2020,$5.70,$0.00,$3775.14,Print
5/28/2020,$4.46,$0.00,$3770.68,Print
5/28/2020,$5.12,$0.00,$3765.56,Print
5/28/2020,$5.12,$0.00,$3760.44,Print
5/28/2020,$5.27,$0.00,$3755.17,Print
5/28/2020,$2.93,$0.00,$3752.24,Print
5/28/2020,$5.27,$0.00,$3746.97,Print
5/28/2020,$5.12,$0.00,$3741.85,Print
5/28/2020,$5.27,$0.00,$3736.58,Print
5/28/2020,$5.27,$0.00,$3731.31,Print
5/28/2020,$5.27,$0.00,$3726.04,Print
5/28/2020,$5.12,$0.00,$3720.92,Print
5/28/2020,$5.08,$0.00,$3715.84,Print
5/28/2020,$2.78,$0.00,$3713.06,Print
5/28/2020,$5.27,$0.00,$3707.79,Print
5/28/2020,$2.78,$0.00,$3705.01,Print
5/28/2020,$4.00,$0.00,$3701.01,Print
5/28/2020,$5.12,$0.00,$3695.89,Print
5/28/2020,$3.25,$0.00,$3692.64,Print
5/28/2020,$5.27,$0.00,$3687.37,Print
5/28/2020,$5.27,$0.00,$3682.10,Print
5/28/2020,$3.39,$0.00,$3678.71,Print
5/28/2020,$5.54,$0.00,$3673.17,Print
5/28/2020,$5.27,$0.00,$3667.90,Print
5/28/2020,$5.27,$0.00,$3662.63,Print
5/28/2020,$3.31,$0.00,$3659.32,Print
5/28/2020,$3.25,$0.00,$3656.07,Print
5/28/2020,$5.27,$0.00,$3650.80,Print
5/28/2020,$5.12,$0.00,$3645.68,Print
5/28/2020,$5.27,$0.00,$3640.41,Print
5/28/2020,$5.27,$0.00,$3635.14,Print
5/28/2020,$5.27,$0.00,$3629.87,Print
5/28/2020,$5.12,$0.00,$3624.75,Print
5/28/2020,$4.00,$0.00,$3620.75,Print
5/28/2020,$3.25,$0.00,$3617.50,Print
5/28/2020,$2.78,$0.00,$3614.72,Print
5/28/2020,$11.19,$0.00,$3603.53,Print
5/28/2020,$8.76,$0.00,$3594.77,Print
5/28/2020,$2.78,$0.00,$3591.99,Print
5/28/2020,$2.74,$0.00,$3589.25,Print
5/28/2020,$4.00,$0.00,$3585.25,Print
5/28/2020,$5.54,$0.00,$3579.71,Print
5/28/2020,$5.12,$0.00,$3574.59,Print
5/28/2020,$5.12,$0.00,$3569.47,Print
5/28/2020,$2.78,$0.00,$3566.69,Print
5/28/2020,$3.67,$0.00,$3563.02,Print
5/28/2020,$2.78,$0.00,$3560.24,Print
5/28/2020,$3.31,$0.00,$3556.93,Print
5/28/2020,$3.18,$0.00,$3553.75,Print
5/28/2020,$2.74,$0.00,$3551.01,Print
5/28/2020,$2.78,$0.00,$3548.23,Print
5/28/2020,$2.84,$0.00,$3545.39,Print
5/28/2020,$4.32,$0.00,$3541.07,Print
5/28/2020,$2.78,$0.00,$3538.29,Print
5/28/2020,$2.74,$0.00,$3535.55,Print
5/28/2020,$2.78,$0.00,$3532.77,Print
5/28/2020,$3.18,$0.00,$3529.59,Print
5/28/2020,$2.78,$0.00,$3526.81,Print
5/28/2020,$3.31,$0.00,$3523.50,Print
5/28/2020,$3.23,$0.00,$3520.27,Print
5/28/2020,$2.78,$0.00,$3517.49,Print
5/28/2020,$2.84,$0.00,$3514.65,Print
5/28/2020,$2.78,$0.00,$3511.87,Print
5/28/2020,$2.78,$0.00,$3509.09,Print
5/28/2020,$3.05,$0.00,$3506.04,Print
5/28/2020,$2.74,$0.00,$3503.30,Print
5/28/2020,$2.74,$0.00,$3500.56,Print
5/28/2020,$2.84,$0.00,$3497.72,Print
5/28/2020,$2.74,$0.00,$3494.98,Print
5/28/2020,$2.74,$0.00,$3492.24,Print
5/28/2020,$2.78,$0.00,$3489.46,Print
5/28/2020,$2.74,$0.00,$3486.72,Print
5/28/2020,$2.84,$0.00,$3483.88,Print
5/28/2020,$2.76,$0.00,$3481.12,Print
5/28/2020,$2.78,$0.00,$3478.34,Print
5/28/2020,$2.84,$0.00,$3475.50,Print
5/28/2020,$5.70,$0.00,$3469.80,Print
5/28/2020,$5.70,$0.00,$3464.10,Print
5/28/2020,$2.84,$0.00,$3461.26,Print
5/28/2020,$3.25,$0.00,$3458.01,Print
5/28/2020,$2.74,$0.00,$3455.27,Print
5/28/2020,$5.54,$0.00,$3449.73,Print
5/28/2020,$2.78,$0.00,$3446.95,Print
5/28/2020,$3.97,$0.00,$3442.98,Print
5/28/2020,$3.31,$0.00,$3439.67,Print
5/28/2020,$3.25,$0.00,$3436.42,Print
5/28/2020,$5.70,$0.00,$3430.72,Print
5/28/2020,$3.25,$0.00,$3427.47,Print
5/28/2020,$3.31,$0.00,$3424.16,Print
5/28/2020,$3.25,$0.00,$3420.91,Print
5/28/2020,$5.08,$0.00,$3415.83,Print
5/28/2020,$2.78,$0.00,$3413.05,Print
5/28/2020,$2.74,$0.00,$3410.31,Print
5/28/2020,$4.18,$0.00,$3406.13,Print
5/28/2020,$3.31,$0.00,$3402.82,Print
5/28/2020,$3.39,$0.00,$3399.43,Print
5/28/2020,$5.27,$0.00,$3394.16,Print
5/28/2020,$2.74,$0.00,$3391.42,Print
5/28/2020,$2.78,$0.00,$3388.64,Print
5/28/2020,$2.84,$0.00,$3385.80,Print
5/28/2020,$2.78,$0.00,$3383.02,Print
5/28/2020,$2.78,$0.00,$3380.24,Print
5/28/2020,$3.52,$0.00,$3376.72,Print
5/28/2020,$3.31,$0.00,$3373.41,Print
5/28/2020,$3.52,$0.00,$3369.89,Print
5/28/2020,$3.25,$0.00,$3366.64,Print
5/28/2020,$3.25,$0.00,$3363.39,Print
5/28/2020,$2.84,$0.00,$3360.55,Print
5/28/2020,$2.76,$0.00,$3357.79,Print
5/28/2020,$5.08,$0.00,$3352.71,Print
5/28/2020,$8.12,$0.00,$3344.59,Print
5/28/2020,$2.78,$0.00,$3341.81,Print
5/28/2020,$4.08,$0.00,$3337.73,Print
5/28/2020,$2.78,$0.00,$3334.95,Print
5/28/2020,$2.76,$0.00,$3332.19,Print
5/28/2020,$3.39,$0.00,$3328.80,Print
5/28/2020,$2.84,$0.00,$3325.96,Print
5/28/2020,$3.31,$0.00,$3322.65,Print
5/28/2020,$3.93,$0.00,$3318.72,Print
5/28/2020,$2.84,$0.00,$3315.88,Print
5/28/2020,$2.74,$0.00,$3313.14,Print
5/28/2020,$2.84,$0.00,$3310.30,Print
5/28/2020,$2.84,$0.00,$3307.46,Print
5/28/2020,$5.12,$0.00,$3302.34,Print
5/28/2020,$3.21,$0.00,$3299.13,Print
5/28/2020,$2.78,$0.00,$3296.35,Print
5/28/2020,$2.74,$0.00,$3293.61,Print
5/28/2020,$2.78,$0.00,$3290.83,Print
5/28/2020,$2.78,$0.00,$3288.05,Print
5/28/2020,$2.78,$0.00,$3285.27,Print
5/28/2020,$5.12,$0.00,$3280.15,Print
5/28/2020,$5.08,$0.00,$3275.07,Print
5/28/2020,$4.46,$0.00,$3270.61,Print
5/28/2020,$34.40,$0.00,$3236.21,Print
5/28/2020,$4.46,$0.00,$3231.75,Print
5/28/2020,$5.27,$0.00,$3226.48,Print
5/28/2020,$3.31,$0.00,$3223.17,Print
5/28/2020,$3.25,$0.00,$3219.92,Print
5/28/2020,$3.52,$0.00,$3216.40,Print
5/28/2020,$3.23,$0.00,$3213.17,Print
5/28/2020,$3.31,$0.00,$3209.86,Print
5/28/2020,$3.93,$0.00,$3205.93,Print
5/28/2020,$4.00,$0.00,$3201.93,Print
5/28/2020,$3.52,$0.00,$3198.41,Print
5/28/2020,$3.93,$0.00,$3194.48,Print
5/28/2020,$3.97,$0.00,$3190.51,Print
5/28/2020,$4.08,$0.00,$3186.43,Print
5/28/2020,$2.84,$0.00,$3183.59,Print
5/28/2020,$2.76,$0.00,$3180.83,Print
5/28/2020,$2.78,$0.00,$3178.05,Print
5/28/2020,$4.08,$0.00,$3173.97,Print
5/28/2020,$4.00,$0.00,$3169.97,Print
5/28/2020,$3.23,$0.00,$3166.74,Print
5/28/2020,$3.21,$0.00,$3163.53,Print
5/28/2020,$3.25,$0.00,$3160.28,Print
5/28/2020,$2.93,$0.00,$3157.35,Print
5/28/2020,$2.84,$0.00,$3154.51,Print
5/28/2020,$3.31,$0.00,$3151.20,Print
5/28/2020,$2.78,$0.00,$3148.42,Print
5/28/2020,$4.08,$0.00,$3144.34,Print
5/28/2020,$4.08,$0.00,$3140.26,Print
5/28/2020,$3.21,$0.00,$3137.05,Print
5/28/2020,$3.93,$0.00,$3133.12,Print
5/28/2020,$3.21,$0.00,$3129.91,Print
5/28/2020,$3.31,$0.00,$3126.60,Print
5/28/2020,$3.39,$0.00,$3123.21,Print
5/28/2020,$3.31,$0.00,$3119.90,Print
5/28/2020,$2.78,$0.00,$3117.12,Print
5/28/2020,$3.67,$0.00,$3113.45,Print
5/28/2020,$3.23,$0.00,$3110.22,Print
5/28/2020,$3.25,$0.00,$3106.97,Print
5/28/2020,$3.25,$0.00,$3103.72,Print
5/28/2020,$3.23,$0.00,$3100.49,Print
5/28/2020,$3.67,$0.00,$3096.82,Print
5/28/2020,$3.31,$0.00,$3093.51,Print
5/28/2020,$2.78,$0.00,$3090.73,Print
5/28/2020,$3.31,$0.00,$3087.42,Print
5/28/2020,$3.25,$0.00,$3084.17,Print
5/28/2020,$3.52,$0.00,$3080.65,Print
5/28/2020,$3.23,$0.00,$3077.42,Print
5/28/2020,$3.23,$0.00,$3074.19,Print
5/28/2020,$3.25,$0.00,$3070.94,Print
5/28/2020,$3.23,$0.00,$3067.71,Print
5/28/2020,$3.23,$0.00,$3064.48,Print
5/28/2020,$3.25,$0.00,$3061.23,Print
5/28/2020,$5.12,$0.00,$3056.11,Print
5/28/2020,$5.27,$0.00,$3050.84,Print
5/28/2020,$5.27,$0.00,$3045.57,Print
5/28/2020,$3.25,$0.00,$3042.32,Print
5/28/2020,$3.21,$0.00,$3039.11,Print
5/28/2020,$3.21,$0.00,$3035.90,Print
5/28/2020,$3.23,$0.00,$3032.67,Print
5/28/2020,$3.25,$0.00,$3029.42,Print
5/28/2020,$3.25,$0.00,$3026.17,Print
5/28/2020,$2.76,$0.00,$3023.41,Print
5/28/2020,$3.25,$0.00,$3020.16,Print
5/28/2020,$3.21,$0.00,$3016.95,Print
5/28/2020,$3.25,$0.00,$3013.70,Print
5/28/2020,$2.78,$0.00,$3010.92,Print
5/28/2020,$2.84,$0.00,$3008.08,Print
5/28/2020,$2.78,$0.00,$3005.30,Print
5/28/2020,$2.74,$0.00,$3002.56,Print
5/28/2020,$3.31,$0.00,$2999.25,Print
5/28/2020,$3.31,$0.00,$2995.94,Print
5/28/2020,$3.21,$0.00,$2992.73,Print
5/28/2020,$3.21,$0.00,$2989.52,Print
5/28/2020,$3.31,$0.00,$2986.21,Print
5/28/2020,$3.23,$0.00,$2982.98,Print
5/28/2020,$3.21,$0.00,$2979.77,Print
5/28/2020,$3.21,$0.00,$2976.56,Print
5/28/2020,$2.74,$0.00,$2973.82,Print
5/28/2020,$3.21,$0.00,$2970.61,Print
5/28/2020,$3.31,$0.00,$2967.30,Print
5/28/2020,$3.25,$0.00,$2964.05,Print
5/28/2020,$3.25,$0.00,$2960.80,Print
5/28/2020,$3.97,$0.00,$2956.83,Print
5/28/2020,$5.40,$0.00,$2951.43,Print
5/28/2020,$3.21,$0.00,$2948.22,Print
5/28/2020,$5.70,$0.00,$2942.52,Print
5/28/2020,$3.31,$0.00,$2939.21,Print
5/28/2020,$3.21,$0.00,$2936.00,Print
5/28/2020,$3.23,$0.00,$2932.77,Print
5/28/2020,$14.18,$0.00,$2918.59,Print
5/28/2020,$5.08,$0.00,$2913.51,Print
5/28/2020,$3.97,$0.00,$2909.54,Print
5/28/2020,$3.39,$0.00,$2906.15,Print
5/28/2020,$3.21,$0.00,$2902.94,Print
5/28/2020,$2.76,$0.00,$2900.18,Print
5/28/2020,$3.25,$0.00,$2896.93,Print
5/28/2020,$2.78,$0.00,$2894.15,Print
5/28/2020,$3.39,$0.00,$2890.76,Print
5/28/2020,$2.93,$0.00,$2887.83,Print
5/28/2020,$3.21,$0.00,$2884.62,Print
5/28/2020,$2.76,$0.00,$2881.86,Print
5/28/2020,$2.76,$0.00,$2879.10,Print
5/28/2020,$3.21,$0.00,$2875.89,Print
5/28/2020,$3.25,$0.00,$2872.64,Print
5/28/2020,$3.31,$0.00,$2869.33,Print
5/28/2020,$3.21,$0.00,$2866.12,Print
5/28/2020,$4.00,$0.00,$2862.12,Print
5/28/2020,$3.25,$0.00,$2858.87,Print
5/28/2020,$4.08,$0.00,$2854.79,Print
5/28/2020,$2.78,$0.00,$2852.01,Print
5/28/2020,$3.21,$0.00,$2848.80,Print
5/28/2020,$3.21,$0.00,$2845.59,Print
5/28/2020,$3.23,$0.00,$2842.36,Print
5/28/2020,$3.21,$0.00,$2839.15,Print
5/28/2020,$3.31,$0.00,$2835.84,Print
5/28/2020,$3.23,$0.00,$2832.61,Print
5/28/2020,$3.52,$0.00,$2829.09,Print
5/28/2020,$3.25,$0.00,$2825.84,Print
5/28/2020,$3.25,$0.00,$2822.59,Print
5/28/2020,$3.31,$0.00,$2819.28,Print
5/28/2020,$3.21,$0.00,$2816.07,Print
5/28/2020,$3.23,$0.00,$2812.84,Print
5/28/2020,$4.08,$0.00,$2808.76,Print
5/28/2020,$3.21,$0.00,$2805.55,Print
5/28/2020,$3.31,$0.00,$2802.24,Print
5/28/2020,$3.25,$0.00,$2798.99,Print
5/28/2020,$3.25,$0.00,$2795.74,Print
5/28/2020,$3.39,$0.00,$2792.35,Print
5/28/2020,$3.21,$0.00,$2789.14,Print
5/28/2020,$3.23,$0.00,$2785.91,Print
5/28/2020,$3.31,$0.00,$2782.60,Print
5/28/2020,$3.52,$0.00,$2779.08,Print
5/28/2020,$7.35,$0.00,$2771.73,Print
5/28/2020,$8.76,$0.00,$2762.97,Print
5/28/2020,$3.31,$0.00,$2759.66,Print
5/28/2020,$3.21,$0.00,$2756.45,Print
5/28/2020,$2.78,$0.00,$2753.67,Print
5/28/2020,$3.67,$0.00,$2750.00,Print
5/28/2020,$3.25,$0.00,$2746.75,Print
5/28/2020,$2.78,$0.00,$2743.97,Print
5/28/2020,$3.25,$0.00,$2740.72,Print
5/28/2020,$3.67,$0.00,$2737.05,Print
5/28/2020,$3.25,$0.00,$2733.80,Print
5/28/2020,$3.31,$0.00,$2730.49,Print
5/28/2020,$2.84,$0.00,$2727.65,Print
5/28/2020,$2.74,$0.00,$2724.91,Print
5/28/2020,$3.25,$0.00,$2721.66,Print
5/28/2020,$2.78,$0.00,$2718.88,Print
5/28/2020,$3.25,$0.00,$2715.63,Print
5/28/2020,$3.25,$0.00,$2712.38,Print
5/28/2020,$3.31,$0.00,$2709.07,Print
5/28/2020,$3.31,$0.00,$2705.76,Print
5/28/2020,$3.31,$0.00,$2702.45,Print
5/28/2020,$2.76,$0.00,$2699.69,Print
5/28/2020,$3.23,$0.00,$2696.46,Print
5/28/2020,$3.31,$0.00,$2693.15,Print
5/28/2020,$2.74,$0.00,$2690.41,Print
5/28/2020,$2.84,$0.00,$2687.57,Print
5/28/2020,$2.84,$0.00,$2684.73,Print
5/28/2020,$2.78,$0.00,$2681.95,Print
5/28/2020,$3.21,$0.00,$2678.74,Print
5/28/2020,$2.74,$0.00,$2676.00,Print
5/28/2020,$2.78,$0.00,$2673.22,Print
5/28/2020,$3.23,$0.00,$2669.99,Print
5/28/2020,$2.74,$0.00,$2667.25,Print
5/28/2020,$2.78,$0.00,$2664.47,Print
5/28/2020,$2.74,$0.00,$2661.73,Print
5/28/2020,$2.74,$0.00,$2658.99,Print
5/28/2020,$2.76,$0.00,$2656.23,Print
5/28/2020,$5.04,$0.00,$2651.19,Print
5/28/2020,$2.76,$0.00,$2648.43,Print
5/28/2020,$2.76,$0.00,$2645.67,Print
5/28/2020,$2.78,$0.00,$2642.89,Print
5/28/2020,$2.84,$0.00,$2640.05,Print
5/28/2020,$2.84,$0.00,$2637.21,Print
5/28/2020,$2.78,$0.00,$2634.43,Print
5/28/2020,$2.84,$0.00,$2631.59,Print
5/28/2020,$2.74,$0.00,$2628.85,Print
5/28/2020,$7.64,$0.00,$2621.21,Print
5/28/2020,$2.76,$0.00,$2618.45,Print
5/28/2020,$2.76,$0.00,$2615.69,Print
5/28/2020,$3.31,$0.00,$2612.38,Print
5/28/2020,$7.84,$0.00,$2604.54,Print
5/28/2020,$2.78,$0.00,$2601.76,Print
5/28/2020,$7.80,$0.00,$2593.96,Print
5/28/2020,$2.84,$0.00,$2591.12,Print
5/28/2020,$2.78,$0.00,$2588.34,Print
5/28/2020,$2.84,$0.00,$2585.50,Print
5/28/2020,$2.76,$0.00,$2582.74,Print
5/28/2020,$2.78,$0.00,$2579.96,Print
5/28/2020,$2.93,$0.00,$2577.03,Print
5/28/2020,$2.78,$0.00,$2574.25,Print
5/28/2020,$2.84,$0.00,$2571.41,Print
5/28/2020,$2.76,$0.00,$2568.65,Print
5/28/2020,$2.76,$0.00,$2565.89,Print
5/28/2020,$2.84,$0.00,$2563.05,Print
5/28/2020,$2.84,$0.00,$2560.21,Print
5/28/2020,$2.84,$0.00,$2557.37,Print
5/28/2020,$2.84,$0.00,$2554.53,Print
5/28/2020,$3.23,$0.00,$2551.30,Print
5/28/2020,$2.78,$0.00,$2548.52,Print
5/28/2020,$3.21,$0.00,$2545.31,Print
5/28/2020,$2.76,$0.00,$2542.55,Print
5/28/2020,$2.78,$0.00,$2539.77,Print
5/28/2020,$2.84,$0.00,$2536.93,Print
5/28/2020,$2.84,$0.00,$2534.09,Print
5/28/2020,$2.76,$0.00,$2531.33,Print
5/28/2020,$2.76,$0.00,$2528.57,Print
5/28/2020,$2.76,$0.00,$2525.81,Print
5/28/2020,$2.78,$0.00,$2523.03,Print
5/28/2020,$2.84,$0.00,$2520.19,Print
5/28/2020,$3.05,$0.00,$2517.14,Print
5/28/2020,$2.84,$0.00,$2514.30,Print
5/28/2020,$2.84,$0.00,$2511.46,Print
5/28/2020,$3.31,$0.00,$2508.15,Print
5/28/2020,$2.78,$0.00,$2505.37,Print
5/28/2020,$2.84,$0.00,$2502.53,Print
5/28/2020,$2.84,$0.00,$2499.69,Print
5/28/2020,$2000.00,$0.00,$4499.69,Purchase
5/28/2020,$2.74,$0.00,$4496.95,Print
5/28/2020,$2.78,$0.00,$4494.17,Print
5/28/2020,$2.74,$0.00,$4491.43,Print
5/28/2020,$2.84,$0.00,$4488.59,Print
5/28/2020,$2.84,$0.00,$4485.75,Print
5/28/2020,$2.78,$0.00,$4482.97,Print
5/28/2020,$2.78,$0.00,$4480.19,Print
5/28/2020,$2.74,$0.00,$4477.45,Print
5/28/2020,$2.78,$0.00,$4474.67,Print
5/28/2020,$2.78,$0.00,$4471.89,Print
5/28/2020,$2.84,$0.00,$4469.05,Print
5/28/2020,$2.84,$0.00,$4466.21,Print
5/28/2020,$3.23,$0.00,$4462.98,Print
5/28/2020,$2.76,$0.00,$4460.22,Print
5/28/2020,$2.76,$0.00,$4457.46,Print
5/28/2020,$2.76,$0.00,$4454.70,Print
5/28/2020,$2.84,$0.00,$4451.86,Print
5/28/2020,$2.76,$0.00,$4449.10,Print
5/28/2020,$2.76,$0.00,$4446.34,Print
5/28/2020,$2.93,$0.00,$4443.41,Print
5/28/2020,$3.23,$0.00,$4440.18,Print
5/28/2020,$2.74,$0.00,$4437.44,Print
5/28/2020,$2.74,$0.00,$4434.70,Print
5/28/2020,$3.21,$0.00,$4431.49,Print
5/28/2020,$3.05,$0.00,$4428.44,Print
5/28/2020,$3.31,$0.00,$4425.13,Print
5/28/2020,$2.74,$0.00,$4422.39,Print
5/28/2020,$2.78,$0.00,$4419.61,Print
5/28/2020,$2.76,$0.00,$4416.85,Print
5/28/2020,$3.31,$0.00,$4413.54,Print
5/28/2020,$2.84,$0.00,$4410.70,Print
5/28/2020,$2.84,$0.00,$4407.86,Print
5/28/2020,$2.84,$0.00,$4405.02,Print
5/28/2020,$7.80,$0.00,$4397.22,Print
5/28/2020,$3.31,$0.00,$4393.91,Print
5/28/2020,$3.31,$0.00,$4390.60,Print
5/28/2020,$21.18,$0.00,$4369.42,Print
5/28/2020,$3.25,$0.00,$4366.17,Print
5/28/2020,$2.78,$0.00,$4363.39,Print
5/28/2020,$3.31,$0.00,$4360.08,Print
5/28/2020,$2.84,$0.00,$4357.24,Print
5/28/2020,$4.18,$0.00,$4353.06,Print
5/28/2020,$3.21,$0.00,$4349.85,Print
5/28/2020,$3.31,$0.00,$4346.54,Print
5/28/2020,$3.31,$0.00,$4343.23,Print
5/28/2020,$2.78,$0.00,$4340.45,Print
5/28/2020,$3.21,$0.00,$4337.24,Print
5/28/2020,$2.78,$0.00,$4334.46,Print
5/28/2020,$3.31,$0.00,$4331.15,Print
5/28/2020,$4.00,$0.00,$4327.15,Print
5/28/2020,$3.21,$0.00,$4323.94,Print
5/28/2020,$2.84,$0.00,$4321.10,Print
5/28/2020,$2.76,$0.00,$4318.34,Print
5/28/2020,$7.56,$0.00,$4310.78,Print
5/28/2020,$3.21,$0.00,$4307.57,Print
5/28/2020,$2.76,$0.00,$4304.81,Print
5/28/2020,$2.84,$0.00,$4301.97,Print
5/28/2020,$3.25,$0.00,$4298.72,Print
5/28/2020,$3.21,$0.00,$4295.51,Print
5/28/2020,$2.84,$0.00,$4292.67,Print
5/28/2020,$2.78,$0.00,$4289.89,Print
5/28/2020,$3.21,$0.00,$4286.68,Print
5/28/2020,$3.21,$0.00,$4283.47,Print
5/28/2020,$2.84,$0.00,$4280.63,Print
5/28/2020,$3.31,$0.00,$4277.32,Print
5/28/2020,$2.84,$0.00,$4274.48,Print
5/28/2020,$4.08,$0.00,$4270.40,Print
5/28/2020,$2.84,$0.00,$4267.56,Print
5/28/2020,$2.84,$0.00,$4264.72,Print
5/28/2020,$3.31,$0.00,$4261.41,Print
5/28/2020,$3.31,$0.00,$4258.10,Print
5/28/2020,$3.23,$0.00,$4254.87,Print
5/28/2020,$2.84,$0.00,$4252.03,Print
5/28/2020,$2.84,$0.00,$4249.19,Print
5/28/2020,$2.84,$0.00,$4246.35,Print
5/28/2020,$2.84,$0.00,$4243.51,Print
5/28/2020,$2.76,$0.00,$4240.75,Print
5/28/2020,$2.84,$0.00,$4237.91,Print
5/28/2020,$2.78,$0.00,$4235.13,Print
5/28/2020,$2.84,$0.00,$4232.29,Print
5/28/2020,$3.31,$0.00,$4228.98,Print
5/28/2020,$2.74,$0.00,$4226.24,Print
5/28/2020,$3.31,$0.00,$4222.93,Print
5/28/2020,$2.84,$0.00,$4220.09,Print
5/28/2020,$2.78,$0.00,$4217.31,Print
5/28/2020,$2.84,$0.00,$4214.47,Print
5/28/2020,$3.23,$0.00,$4211.24,Print
5/28/2020,$2.84,$0.00,$4208.40,Print
5/28/2020,$2.84,$0.00,$4205.56,Print
5/28/2020,$2.78,$0.00,$4202.78,Print
5/28/2020,$2.84,$0.00,$4199.94,Print
5/28/2020,$2.78,$0.00,$4197.16,Print
5/28/2020,$2.93,$0.00,$4194.23,Print
5/28/2020,$2.84,$0.00,$4191.39,Print
5/28/2020,$2.84,$0.00,$4188.55,Print
5/28/2020,$3.23,$0.00,$4185.32,Print
5/28/2020,$2.84,$0.00,$4182.48,Print
5/28/2020,$2.74,$0.00,$4179.74,Print
5/28/2020,$2.84,$0.00,$4176.90,Print
5/28/2020,$2.78,$0.00,$4174.12,Print
5/28/2020,$2.76,$0.00,$4171.36,Print
5/28/2020,$3.39,$0.00,$4167.97,Print
5/28/2020,$2.76,$0.00,$4165.21,Print
5/28/2020,$2.78,$0.00,$4162.43,Print
5/28/2020,$2.78,$0.00,$4159.65,Print
5/28/2020,$2.84,$0.00,$4156.81,Print
5/28/2020,$2.84,$0.00,$4153.97,Print
5/28/2020,$2.78,$0.00,$4151.19,Print
5/28/2020,$2.74,$0.00,$4148.45,Print
5/28/2020,$2.84,$0.00,$4145.61,Print
5/29/2020,$4.08,$0.00,$4141.53,Print
5/29/2020,$3.31,$0.00,$4138.22,Print
5/29/2020,$2.84,$0.00,$4135.38,Print
5/29/2020,$3.23,$0.00,$4132.15,Print
5/29/2020,$2.78,$0.00,$4129.37,Print
5/29/2020,$2.78,$0.00,$4126.59,Print
5/29/2020,$3.93,$0.00,$4122.66,Print
5/29/2020,$2.78,$0.00,$4119.88,Print
5/29/2020,$2.78,$0.00,$4117.10,Print
5/29/2020,$2.78,$0.00,$4114.32,Print
5/29/2020,$2.78,$0.00,$4111.54,Print
5/29/2020,$2.78,$0.00,$4108.76,Print
5/29/2020,$2.78,$0.00,$4105.98,Print
5/29/2020,$2.84,$0.00,$4103.14,Print
5/29/2020,$2.84,$0.00,$4100.30,Print
5/29/2020,$4.00,$0.00,$4096.30,Print
5/29/2020,$3.93,$0.00,$4092.37,Print
5/29/2020,$2.78,$0.00,$4089.59,Print
5/29/2020,$2.78,$0.00,$4086.81,Print
5/29/2020,$2.74,$0.00,$4084.07,Print
5/29/2020,$2.74,$0.00,$4081.33,Print
5/29/2020,$2.76,$0.00,$4078.57,Print
5/29/2020,$2.74,$0.00,$4075.83,Print
5/29/2020,$5.12,$0.00,$4070.71,Print
5/29/2020,$3.23,$0.00,$4067.48,Print
5/29/2020,$3.31,$0.00,$4064.17,Print
5/29/2020,$2.78,$0.00,$4061.39,Print
5/29/2020,$3.21,$0.00,$4058.18,Print
5/29/2020,$2.74,$0.00,$4055.44,Print
5/29/2020,$2.84,$0.00,$4052.60,Print
5/29/2020,$2.84,$0.00,$4049.76,Print
5/29/2020,$7.35,$0.00,$4042.41,Print
5/29/2020,$2.84,$0.00,$4039.57,Print
5/29/2020,$2.84,$0.00,$4036.73,Print
5/29/2020,$2.74,$0.00,$4033.99,Print
5/29/2020,$2.78,$0.00,$4031.21,Print
5/29/2020,$2.84,$0.00,$4028.37,Print
5/29/2020,$2.84,$0.00,$4025.53,Print
5/29/2020,$2.78,$0.00,$4022.75,Print
5/29/2020,$2.84,$0.00,$4019.91,Print
5/29/2020,$3.31,$0.00,$4016.60,Print
5/29/2020,$2.76,$0.00,$4013.84,Print
5/29/2020,$2.76,$0.00,$4011.08,Print
5/29/2020,$2.84,$0.00,$4008.24,Print
5/29/2020,$2.84,$0.00,$4005.40,Print
5/29/2020,$2.78,$0.00,$4002.62,Print
5/29/2020,$2.84,$0.00,$3999.78,Print
5/29/2020,$2.84,$0.00,$3996.94,Print
5/29/2020,$2.78,$0.00,$3994.16,Print
5/29/2020,$2.84,$0.00,$3991.32,Print
5/29/2020,$3.31,$0.00,$3988.01,Print
5/29/2020,$2.74,$0.00,$3985.27,Print
5/29/2020,$2.74,$0.00,$3982.53,Print
5/29/2020,$2.84,$0.00,$3979.69,Print
5/29/2020,$2.78,$0.00,$3976.91,Print
5/29/2020,$2.84,$0.00,$3974.07,Print
5/29/2020,$2.78,$0.00,$3971.29,Print
5/29/2020,$3.31,$0.00,$3967.98,Print
5/29/2020,$2.78,$0.00,$3965.20,Print
5/29/2020,$2.78,$0.00,$3962.42,Print
5/29/2020,$2.78,$0.00,$3959.64,Print
5/29/2020,$2.78,$0.00,$3956.86,Print
5/29/2020,$2.84,$0.00,$3954.02,Print
5/29/2020,$2.84,$0.00,$3951.18,Print
5/29/2020,$2.84,$0.00,$3948.34,Print
5/29/2020,$2.76,$0.00,$3945.58,Print
5/29/2020,$2.84,$0.00,$3942.74,Print
5/29/2020,$2.84,$0.00,$3939.90,Print
5/29/2020,$2.84,$0.00,$3937.06,Print
5/29/2020,$2.84,$0.00,$3934.22,Print
5/29/2020,$2.84,$0.00,$3931.38,Print
5/29/2020,$2.93,$0.00,$3928.45,Print
5/29/2020,$2.78,$0.00,$3925.67,Print
5/29/2020,$2.84,$0.00,$3922.83,Print
5/29/2020,$2.84,$0.00,$3919.99,Print
5/29/2020,$2.76,$0.00,$3917.23,Print
5/29/2020,$2.78,$0.00,$3914.45,Print
5/29/2020,$2.84,$0.00,$3911.61,Print
5/29/2020,$2.84,$0.00,$3908.77,Print
5/29/2020,$2.78,$0.00,$3905.99,Print
5/29/2020,$2.84,$0.00,$3903.15,Print
5/29/2020,$2.84,$0.00,$3900.31,Print
5/29/2020,$2.84,$0.00,$3897.47,Print
5/29/2020,$2.84,$0.00,$3894.63,Print
5/29/2020,$2.84,$0.00,$3891.79,Print
5/29/2020,$2.76,$0.00,$3889.03,Print
5/29/2020,$2.84,$0.00,$3886.19,Print
5/29/2020,$2.74,$0.00,$3883.45,Print
5/29/2020,$2.78,$0.00,$3880.67,Print
5/29/2020,$2.76,$0.00,$3877.91,Print
5/29/2020,$2.76,$0.00,$3875.15,Print
5/29/2020,$3.05,$0.00,$3872.10,Print
5/29/2020,$3.05,$0.00,$3869.05,Print
5/29/2020,$2.84,$0.00,$3866.21,Print
5/29/2020,$3.05,$0.00,$3863.16,Print
5/29/2020,$2.84,$0.00,$3860.32,Print
5/29/2020,$3.31,$0.00,$3857.01,Print
5/29/2020,$3.21,$0.00,$3853.80,Print
5/29/2020,$2.76,$0.00,$3851.04,Print
5/29/2020,$2.84,$0.00,$3848.20,Print
5/29/2020,$2.84,$0.00,$3845.36,Print
5/29/2020,$2.74,$0.00,$3842.62,Print
5/29/2020,$2.74,$0.00,$3839.88,Print
5/29/2020,$3.21,$0.00,$3836.67,Print
5/29/2020,$2.84,$0.00,$3833.83,Print
5/29/2020,$3.23,$0.00,$3830.60,Print
5/29/2020,$2.76,$0.00,$3827.84,Print
5/29/2020,$3.21,$0.00,$3824.63,Print
5/29/2020,$2.84,$0.00,$3821.79,Print
5/29/2020,$2.78,$0.00,$3819.01,Print
5/29/2020,$2.84,$0.00,$3816.17,Print
5/29/2020,$2.74,$0.00,$3813.43,Print
5/29/2020,$3.97,$0.00,$3809.46,Print
5/29/2020,$2.84,$0.00,$3806.62,Print
5/29/2020,$2.84,$0.00,$3803.78,Print
5/29/2020,$2.76,$0.00,$3801.02,Print
5/29/2020,$2.74,$0.00,$3798.28,Print
5/29/2020,$46.01,$0.00,$3752.27,Print
5/29/2020,$2.84,$0.00,$3749.43,Print
5/29/2020,$2.84,$0.00,$3746.59,Print
5/29/2020,$3.25,$0.00,$3743.34,Print
5/29/2020,$2.84,$0.00,$3740.50,Print
5/29/2020,$3.23,$0.00,$3737.27,Print
5/29/2020,$3.31,$0.00,$3733.96,Print
5/29/2020,$2.84,$0.00,$3731.12,Print
5/29/2020,$2.84,$0.00,$3728.28,Print
5/29/2020,$3.31,$0.00,$3724.97,Print
5/29/2020,$3.25,$0.00,$3721.72,Print
5/29/2020,$3.25,$0.00,$3718.47,Print
5/29/2020,$2.78,$0.00,$3715.69,Print
5/29/2020,$3.31,$0.00,$3712.38,Print
5/29/2020,$3.25,$0.00,$3709.13,Print
5/29/2020,$4.32,$0.00,$3704.81,Print
5/29/2020,$2.78,$0.00,$3702.03,Print
5/29/2020,$3.25,$0.00,$3698.78,Print
5/29/2020,$2.84,$0.00,$3695.94,Print
5/29/2020,$2.93,$0.00,$3693.01,Print
5/29/2020,$2.78,$0.00,$3690.23,Print
5/29/2020,$3.05,$0.00,$3687.18,Print
5/29/2020,$5.08,$0.00,$3682.10,Print
5/29/2020,$2.78,$0.00,$3679.32,Print
5/29/2020,$2.78,$0.00,$3676.54,Print
5/29/2020,$2.78,$0.00,$3673.76,Print
5/29/2020,$2.74,$0.00,$3671.02,Print
5/29/2020,$2.78,$0.00,$3668.24,Print
5/29/2020,$2.93,$0.00,$3665.31,Print
5/29/2020,$2.74,$0.00,$3662.57,Print
5/29/2020,$2.84,$0.00,$3659.73,Print
5/29/2020,$2.84,$0.00,$3656.89,Print
5/29/2020,$2.84,$0.00,$3654.05,Print
5/29/2020,$8.76,$0.00,$3645.29,Print
5/29/2020,$3.31,$0.00,$3641.98,Print
5/29/2020,$2.74,$0.00,$3639.24,Print
5/29/2020,$2.93,$0.00,$3636.31,Print
5/29/2020,$2.78,$0.00,$3633.53,Print
5/29/2020,$3.05,$0.00,$3630.48,Print
5/29/2020,$3.05,$0.00,$3627.43,Print
5/29/2020,$3.25,$0.00,$3624.18,Print
5/29/2020,$2.93,$0.00,$3621.25,Print
5/29/2020,$2.78,$0.00,$3618.47,Print
5/29/2020,$2.78,$0.00,$3615.69,Print
5/29/2020,$3.05,$0.00,$3612.64,Print
5/29/2020,$2.78,$0.00,$3609.86,Print
5/29/2020,$3.93,$0.00,$3605.93,Print
5/29/2020,$2.78,$0.00,$3603.15,Print
5/29/2020,$2.78,$0.00,$3600.37,Print
5/29/2020,$2.84,$0.00,$3597.53,Print
5/29/2020,$2.78,$0.00,$3594.75,Print
5/29/2020,$2.84,$0.00,$3591.91,Print
5/29/2020,$2.78,$0.00,$3589.13,Print
5/29/2020,$2.78,$0.00,$3586.35,Print
5/29/2020,$2.78,$0.00,$3583.57,Print
5/29/2020,$2.84,$0.00,$3580.73,Print
5/29/2020,$2.78,$0.00,$3577.95,Print
5/29/2020,$2.78,$0.00,$3575.17,Print
5/29/2020,$2.78,$0.00,$3572.39,Print
5/29/2020,$3.21,$0.00,$3569.18,Print
5/29/2020,$2.84,$0.00,$3566.34,Print
5/29/2020,$2.78,$0.00,$3563.56,Print
5/29/2020,$2.74,$0.00,$3560.82,Print
5/29/2020,$2.84,$0.00,$3557.98,Print
5/29/2020,$2.78,$0.00,$3555.20,Print
5/29/2020,$2.78,$0.00,$3552.42,Print
5/29/2020,$2.78,$0.00,$3549.64,Print
5/29/2020,$2.93,$0.00,$3546.71,Print
5/29/2020,$2.78,$0.00,$3543.93,Print
5/29/2020,$2.78,$0.00,$3541.15,Print
5/29/2020,$3.21,$0.00,$3537.94,Print
5/29/2020,$3.25,$0.00,$3534.69,Print
5/29/2020,$3.21,$0.00,$3531.48,Print
5/29/2020,$2.78,$0.00,$3528.70,Print
5/29/2020,$3.25,$0.00,$3525.45,Print
5/29/2020,$3.31,$0.00,$3522.14,Print
5/29/2020,$2.74,$0.00,$3519.40,Print
5/29/2020,$2.84,$0.00,$3516.56,Print
5/29/2020,$2.74,$0.00,$3513.82,Print
5/29/2020,$3.67,$0.00,$3510.15,Print
5/29/2020,$2.84,$0.00,$3507.31,Print
5/29/2020,$3.25,$0.00,$3504.06,Print
5/29/2020,$3.25,$0.00,$3500.81,Print
5/29/2020,$3.52,$0.00,$3497.29,Print
5/29/2020,$3.39,$0.00,$3493.90,Print
5/29/2020,$2.78,$0.00,$3491.12,Print
5/29/2020,$3.23,$0.00,$3487.89,Print
5/29/2020,$3.05,$0.00,$3484.84,Print
5/29/2020,$2.76,$0.00,$3482.08,Print
5/29/2020,$2.93,$0.00,$3479.15,Print
5/29/2020,$2.84,$0.00,$3476.31,Print
5/29/2020,$2.93,$0.00,$3473.38,Print
5/29/2020,$2.78,$0.00,$3470.60,Print
5/29/2020,$3.25,$0.00,$3467.35,Print
5/29/2020,$25.88,$0.00,$3441.47,Print
5/29/2020,$25.88,$0.00,$3415.59,Print
5/29/2020,$3.52,$0.00,$3412.07,Print
5/29/2020,$25.88,$0.00,$3386.19,Print
5/29/2020,$25.88,$0.00,$3360.31,Print
5/29/2020,$25.88,$0.00,$3334.43,Print
5/29/2020,$2.84,$0.00,$3331.59,Print
5/29/2020,$2.78,$0.00,$3328.81,Print
5/29/2020,$2.84,$0.00,$3325.97,Print
5/29/2020,$2.78,$0.00,$3323.19,Print
5/29/2020,$2.78,$0.00,$3320.41,Print
5/29/2020,$2.84,$0.00,$3317.57,Print
5/29/2020,$2.84,$0.00,$3314.73,Print
5/29/2020,$2.74,$0.00,$3311.99,Print
5/29/2020,$3.52,$0.00,$3308.47,Print
5/29/2020,$2.78,$0.00,$3305.69,Print
5/29/2020,$2.84,$0.00,$3302.85,Print
5/29/2020,$3.25,$0.00,$3299.60,Print
5/29/2020,$2.78,$0.00,$3296.82,Print
5/29/2020,$2.84,$0.00,$3293.98,Print
5/29/2020,$3.39,$0.00,$3290.59,Print
5/29/2020,$2.78,$0.00,$3287.81,Print
5/29/2020,$2.78,$0.00,$3285.03,Print
5/29/2020,$3.21,$0.00,$3281.82,Print
5/29/2020,$2.78,$0.00,$3279.04,Print
5/29/2020,$2.78,$0.00,$3276.26,Print
5/29/2020,$3.23,$0.00,$3273.03,Print
5/29/2020,$2.84,$0.00,$3270.19,Print
5/29/2020,$2.74,$0.00,$3267.45,Print
5/29/2020,$3.25,$0.00,$3264.20,Print
5/29/2020,$3.21,$0.00,$3260.99,Print
5/29/2020,$3.31,$0.00,$3257.68,Print
5/29/2020,$5.70,$0.00,$3251.98,Print
5/29/2020,$2.84,$0.00,$3249.14,Print
5/29/2020,$3.52,$0.00,$3245.62,Print
5/29/2020,$2.84,$0.00,$3242.78,Print
5/29/2020,$2.78,$0.00,$3240.00,Print
5/29/2020,$3.21,$0.00,$3236.79,Print
5/29/2020,$2.74,$0.00,$3234.05,Print
5/29/2020,$3.93,$0.00,$3230.12,Print
5/29/2020,$2.84,$0.00,$3227.28,Print
5/29/2020,$3.25,$0.00,$3224.03,Print
5/29/2020,$3.21,$0.00,$3220.82,Print
5/29/2020,$3.23,$0.00,$3217.59,Print
5/29/2020,$2.76,$0.00,$3214.83,Print
5/29/2020,$5.27,$0.00,$3209.56,Print
5/29/2020,$2.78,$0.00,$3206.78,Print
5/29/2020,$2.74,$0.00,$3204.04,Print
5/29/2020,$2.78,$0.00,$3201.26,Print
5/29/2020,$2.76,$0.00,$3198.50,Print
5/29/2020,$5.27,$0.00,$3193.23,Print
5/29/2020,$2.78,$0.00,$3190.45,Print
5/29/2020,$4.08,$0.00,$3186.37,Print
5/29/2020,$2.84,$0.00,$3183.53,Print
5/29/2020,$3.97,$0.00,$3179.56,Print
5/29/2020,$3.21,$0.00,$3176.35,Print
5/29/2020,$3.31,$0.00,$3173.04,Print
5/29/2020,$2.84,$0.00,$3170.20,Print
5/29/2020,$3.23,$0.00,$3166.97,Print
5/29/2020,$3.39,$0.00,$3163.58,Print
5/29/2020,$3.18,$0.00,$3160.40,Print
5/29/2020,$8.15,$0.00,$3152.25,Print
5/29/2020,$2.78,$0.00,$3149.47,Print
5/29/2020,$3.31,$0.00,$3146.16,Print
5/29/2020,$3.31,$0.00,$3142.85,Print
5/29/2020,$8.15,$0.00,$3134.70,Print
5/29/2020,$2.78,$0.00,$3131.92,Print
5/29/2020,$2.78,$0.00,$3129.14,Print
5/29/2020,$2.78,$0.00,$3126.36,Print
5/29/2020,$3.31,$0.00,$3123.05,Print
5/29/2020,$3.25,$0.00,$3119.80,Print
5/29/2020,$2.84,$0.00,$3116.96,Print
5/29/2020,$3.21,$0.00,$3113.75,Print
5/29/2020,$3.23,$0.00,$3110.52,Print
5/29/2020,$2.84,$0.00,$3107.68,Print
5/29/2020,$2.84,$0.00,$3104.84,Print
5/29/2020,$3.23,$0.00,$3101.61,Print
5/29/2020,$3.93,$0.00,$3097.68,Print
5/29/2020,$3.25,$0.00,$3094.43,Print
5/29/2020,$2.74,$0.00,$3091.69,Print
5/29/2020,$2.78,$0.00,$3088.91,Print
5/29/2020,$3.18,$0.00,$3085.73,Print
5/29/2020,$2.74,$0.00,$3082.99,Print
5/29/2020,$3.31,$0.00,$3079.68,Print
5/29/2020,$2.78,$0.00,$3076.90,Print
5/29/2020,$2.74,$0.00,$3074.16,Print
5/29/2020,$2.78,$0.00,$3071.38,Print
5/29/2020,$3.25,$0.00,$3068.13,Print
5/29/2020,$3.25,$0.00,$3064.88,Print
5/29/2020,$2.78,$0.00,$3062.10,Print
5/29/2020,$2.84,$0.00,$3059.26,Print
5/29/2020,$3.05,$0.00,$3056.21,Print
5/29/2020,$2.78,$0.00,$3053.43,Print
5/29/2020,$4.00,$0.00,$3049.43,Print
5/29/2020,$3.67,$0.00,$3045.76,Print
5/29/2020,$3.52,$0.00,$3042.24,Print
5/29/2020,$3.52,$0.00,$3038.72,Print
5/29/2020,$5.27,$0.00,$3033.45,Print
5/29/2020,$3.31,$0.00,$3030.14,Print
5/29/2020,$3.25,$0.00,$3026.89,Print
5/29/2020,$5.12,$0.00,$3021.77,Print
5/29/2020,$3.31,$0.00,$3018.46,Print
5/29/2020,$5.12,$0.00,$3013.34,Print
5/29/2020,$3.25,$0.00,$3010.09,Print
5/29/2020,$2.84,$0.00,$3007.25,Print
5/29/2020,$5.70,$0.00,$3001.55,Print
5/29/2020,$3.25,$0.00,$2998.30,Print
5/29/2020,$2.84,$0.00,$2995.46,Print
5/29/2020,$3.39,$0.00,$2992.07,Print
5/29/2020,$2.84,$0.00,$2989.23,Print
5/29/2020,$3.39,$0.00,$2985.84,Print
5/29/2020,$3.25,$0.00,$2982.59,Print
5/29/2020,$2.76,$0.00,$2979.83,Print
5/29/2020,$3.21,$0.00,$2976.62,Print
5/29/2020,$2.84,$0.00,$2973.78,Print
5/29/2020,$2.84,$0.00,$2970.94,Print
5/29/2020,$3.21,$0.00,$2967.73,Print
5/29/2020,$3.25,$0.00,$2964.48,Print
5/29/2020,$2.93,$0.00,$2961.55,Print
5/29/2020,$2.93,$0.00,$2958.62,Print
5/29/2020,$4.00,$0.00,$2954.62,Print
5/29/2020,$3.39,$0.00,$2951.23,Print
5/29/2020,$2.78,$0.00,$2948.45,Print
5/29/2020,$2.84,$0.00,$2945.61,Print
5/29/2020,$2.78,$0.00,$2942.83,Print
5/29/2020,$2.76,$0.00,$2940.07,Print
5/29/2020,$3.52,$0.00,$2936.55,Print
5/29/2020,$3.23,$0.00,$2933.32,Print
5/29/2020,$3.52,$0.00,$2929.80,Print
5/29/2020,$3.39,$0.00,$2926.41,Print
5/29/2020,$3.25,$0.00,$2923.16,Print
5/29/2020,$3.52,$0.00,$2919.64,Print
5/29/2020,$3.67,$0.00,$2915.97,Print
5/29/2020,$2.76,$0.00,$2913.21,Print
5/29/2020,$3.23,$0.00,$2909.98,Print
5/29/2020,$3.25,$0.00,$2906.73,Print
5/29/2020,$3.25,$0.00,$2903.48,Print
5/29/2020,$2.84,$0.00,$2900.64,Print
5/29/2020,$3.21,$0.00,$2897.43,Print
5/29/2020,$3.31,$0.00,$2894.12,Print
5/29/2020,$3.25,$0.00,$2890.87,Print
5/29/2020,$3.31,$0.00,$2887.56,Print
5/29/2020,$3.25,$0.00,$2884.31,Print
5/29/2020,$2.76,$0.00,$2881.55,Print
5/29/2020,$3.21,$0.00,$2878.34,Print
5/29/2020,$2.78,$0.00,$2875.56,Print
5/29/2020,$3.93,$0.00,$2871.63,Print
5/29/2020,$3.52,$0.00,$2868.11,Print
5/29/2020,$2.84,$0.00,$2865.27,Print
5/29/2020,$3.23,$0.00,$2862.04,Print
5/29/2020,$2.76,$0.00,$2859.28,Print
5/29/2020,$2.74,$0.00,$2856.54,Print
5/29/2020,$3.23,$0.00,$2853.31,Print
5/29/2020,$4.00,$0.00,$2849.31,Print
5/29/2020,$3.25,$0.00,$2846.06,Print
5/29/2020,$3.21,$0.00,$2842.85,Print
5/29/2020,$3.39,$0.00,$2839.46,Print
5/29/2020,$2.76,$0.00,$2836.70,Print
5/29/2020,$3.31,$0.00,$2833.39,Print
5/29/2020,$3.31,$0.00,$2830.08,Print
5/29/2020,$3.31,$0.00,$2826.77,Print
5/29/2020,$2.76,$0.00,$2824.01,Print
5/29/2020,$4.08,$0.00,$2819.93,Print
5/29/2020,$4.08,$0.00,$2815.85,Print
5/29/2020,$4.08,$0.00,$2811.77,Print
5/29/2020,$2.84,$0.00,$2808.93,Print
5/29/2020,$2.74,$0.00,$2806.19,Print
5/29/2020,$3.25,$0.00,$2802.94,Print
5/29/2020,$3.31,$0.00,$2799.63,Print
5/29/2020,$5.04,$0.00,$2794.59,Print
5/29/2020,$3.25,$0.00,$2791.34,Print
5/29/2020,$3.25,$0.00,$2788.09,Print
5/29/2020,$3.21,$0.00,$2784.88,Print
5/29/2020,$3.93,$0.00,$2780.95,Print
5/29/2020,$2.78,$0.00,$2778.17,Print
5/29/2020,$3.25,$0.00,$2774.92,Print
5/29/2020,$3.31,$0.00,$2771.61,Print
5/29/2020,$3.25,$0.00,$2768.36,Print
5/29/2020,$2.78,$0.00,$2765.58,Print
5/29/2020,$3.31,$0.00,$2762.27,Print
5/29/2020,$3.25,$0.00,$2759.02,Print
5/29/2020,$3.25,$0.00,$2755.77,Print
5/29/2020,$3.31,$0.00,$2752.46,Print
5/29/2020,$3.52,$0.00,$2748.94,Print
5/29/2020,$3.21,$0.00,$2745.73,Print
5/29/2020,$3.39,$0.00,$2742.34,Print
5/29/2020,$3.39,$0.00,$2738.95,Print
5/29/2020,$3.25,$0.00,$2735.70,Print
5/29/2020,$3.25,$0.00,$2732.45,Print
5/29/2020,$3.25,$0.00,$2729.20,Print
5/29/2020,$3.31,$0.00,$2725.89,Print
5/29/2020,$3.25,$0.00,$2722.64,Print
5/29/2020,$3.39,$0.00,$2719.25,Print
5/29/2020,$3.23,$0.00,$2716.02,Print
5/29/2020,$11.19,$0.00,$2704.83,Print
5/29/2020,$3.52,$0.00,$2701.31,Print
5/29/2020,$3.23,$0.00,$2698.08,Print
5/29/2020,$2.78,$0.00,$2695.30,Print
5/29/2020,$2.84,$0.00,$2692.46,Print
5/29/2020,$2.74,$0.00,$2689.72,Print
5/29/2020,$4.00,$0.00,$2685.72,Print
5/29/2020,$2.84,$0.00,$2682.88,Print
5/29/2020,$3.21,$0.00,$2679.67,Print
5/29/2020,$5.27,$0.00,$2674.40,Print
5/29/2020,$3.31,$0.00,$2671.09,Print
5/29/2020,$3.21,$0.00,$2667.88,Print
5/29/2020,$3.21,$0.00,$2664.67,Print
5/29/2020,$3.21,$0.00,$2661.46,Print
5/29/2020,$3.31,$0.00,$2658.15,Print
5/29/2020,$3.25,$0.00,$2654.90,Print
5/29/2020,$3.31,$0.00,$2651.59,Print
5/29/2020,$3.25,$0.00,$2648.34,Print
5/29/2020,$3.25,$0.00,$2645.09,Print
5/29/2020,$3.67,$0.00,$2641.42,Print
5/29/2020,$3.25,$0.00,$2638.17,Print
5/29/2020,$3.25,$0.00,$2634.92,Print
5/29/2020,$3.25,$0.00,$2631.67,Print
5/29/2020,$3.23,$0.00,$2628.44,Print
5/29/2020,$3.31,$0.00,$2625.13,Print
5/29/2020,$7.84,$0.00,$2617.29,Print
5/29/2020,$3.21,$0.00,$2614.08,Print
5/29/2020,$4.08,$0.00,$2610.00,Print
5/29/2020,$4.18,$0.00,$2605.82,Print
5/29/2020,$3.21,$0.00,$2602.61,Print
5/29/2020,$3.21,$0.00,$2599.40,Print
5/29/2020,$3.21,$0.00,$2596.19,Print
5/29/2020,$4.00,$0.00,$2592.19,Print
5/29/2020,$3.25,$0.00,$2588.94,Print
5/29/2020,$3.31,$0.00,$2585.63,Print
5/29/2020,$2.78,$0.00,$2582.85,Print
5/29/2020,$2.78,$0.00,$2580.07,Print
5/29/2020,$3.31,$0.00,$2576.76,Print
5/29/2020,$2.76,$0.00,$2574.00,Print
5/29/2020,$2.78,$0.00,$2571.22,Print
5/29/2020,$2.93,$0.00,$2568.29,Print
5/29/2020,$3.18,$0.00,$2565.11,Print
5/29/2020,$2.78,$0.00,$2562.33,Print
5/29/2020,$3.31,$0.00,$2559.02,Print
5/29/2020,$3.21,$0.00,$2555.81,Print
5/29/2020,$2.78,$0.00,$2553.03,Print
5/29/2020,$2.93,$0.00,$2550.10,Print
5/29/2020,$4.00,$0.00,$2546.10,Print
5/29/2020,$2.78,$0.00,$2543.32,Print
5/29/2020,$2.78,$0.00,$2540.54,Print
5/29/2020,$7.35,$0.00,$2533.19,Print
5/29/2020,$4.00,$0.00,$2529.19,Print
5/29/2020,$2.76,$0.00,$2526.43,Print
5/29/2020,$5.70,$0.00,$2520.73,Print
5/29/2020,$2.78,$0.00,$2517.95,Print
5/29/2020,$5.27,$0.00,$2512.68,Print
5/29/2020,$5.12,$0.00,$2507.56,Print
5/29/2020,$2.78,$0.00,$2504.78,Print
5/29/2020,$2.76,$0.00,$2502.02,Print
5/29/2020,$2.84,$0.00,$2499.18,Print
5/29/2020,$2000.00,$0.00,$4499.18,Purchase
5/29/2020,$4.08,$0.00,$4495.10,Print
5/29/2020,$3.25,$0.00,$4491.85,Print
5/29/2020,$3.23,$0.00,$4488.62,Print
5/29/2020,$3.21,$0.00,$4485.41,Print
5/29/2020,$2.84,$0.00,$4482.57,Print
5/29/2020,$2.84,$0.00,$4479.73,Print
5/29/2020,$2.84,$0.00,$4476.89,Print
5/29/2020,$2.84,$0.00,$4474.05,Print
5/29/2020,$4.00,$0.00,$4470.05,Print
5/29/2020,$3.31,$0.00,$4466.74,Print
5/29/2020,$2.78,$0.00,$4463.96,Print
5/29/2020,$4.46,$0.00,$4459.50,Print
5/29/2020,$7.56,$0.00,$4451.94,Print
5/29/2020,$2.78,$0.00,$4449.16,Print
5/29/2020,$8.50,$0.00,$4440.66,Print
5/29/2020,$3.21,$0.00,$4437.45,Print
5/29/2020,$3.39,$0.00,$4434.06,Print
5/29/2020,$8.04,$0.00,$4426.02,Print
5/29/2020,$3.21,$0.00,$4422.81,Print
5/29/2020,$20.62,$0.00,$4402.19,Print
5/29/2020,$15.14,$0.00,$4387.05,Print
5/29/2020,$15.14,$0.00,$4371.91,Print
5/29/2020,$15.14,$0.00,$4356.77,Print
5/29/2020,$15.14,$0.00,$4341.63,Print
5/29/2020,$15.14,$0.00,$4326.49,Print
5/29/2020,$0.00,$2.47,$4328.96,Adjustment
5/29/2020,$0.00,$2.43,$4331.39,Adjustment
5/29/2020,$0.00,$2.43,$4333.82,Adjustment
5/29/2020,$0.00,$2.43,$4336.25,Adjustment
5/29/2020,$0.00,$2.43,$4338.68,Adjustment
5/29/2020,$0.00,$2.43,$4341.11,Adjustment
5/29/2020,$0.00,$2.43,$4343.54,Adjustment
5/29/2020,$0.00,$2.43,$4345.97,Adjustment
5/29/2020,$0.00,$2.43,$4348.40,Adjustment
5/29/2020,$0.00,$2.43,$4350.83,Adjustment
5/29/2020,$0.00,$2.43,$4353.26,Adjustment
5/29/2020,$0.00,$2.43,$4355.69,Adjustment
5/29/2020,$0.00,$2.43,$4358.12,Adjustment
5/29/2020,$0.00,$2.43,$4360.55,Adjustment
5/29/2020,$0.00,$2.43,$4362.98,Adjustment
5/29/2020,$0.00,$2.43,$4365.41,Adjustment
5/29/2020,$0.00,$2.43,$4367.84,Adjustment
5/29/2020,$0.00,$2.43,$4370.27,Adjustment
5/29/2020,$0.00,$2.43,$4372.70,Adjustment
5/29/2020,$0.00,$2.34,$4375.04,Adjustment
5/29/2020,$0.00,$2.34,$4377.38,Adjustment
5/29/2020,$0.00,$2.34,$4379.72,Adjustment
5/29/2020,$0.00,$2.34,$4382.06,Adjustment
5/29/2020,$0.00,$2.34,$4384.40,Adjustment
5/29/2020,$0.00,$2.34,$4386.74,Adjustment
5/29/2020,$0.00,$2.34,$4389.08,Adjustment
5/29/2020,$0.00,$2.34,$4391.42,Adjustment
5/29/2020,$0.00,$2.34,$4393.76,Adjustment
5/29/2020,$0.00,$2.34,$4396.10,Adjustment
5/29/2020,$0.00,$2.34,$4398.44,Adjustment
5/29/2020,$0.00,$2.34,$4400.78,Adjustment
5/29/2020,$0.00,$2.34,$4403.12,Adjustment
5/29/2020,$0.00,$2.34,$4405.46,Adjustment
5/29/2020,$0.00,$2.34,$4407.80,Adjustment
5/29/2020,$0.00,$2.34,$4410.14,Adjustment
5/29/2020,$0.00,$2.32,$4412.46,Adjustment
5/29/2020,$0.00,$2.32,$4414.78,Adjustment
5/29/2020,$0.00,$2.30,$4417.08,Adjustment
5/29/2020,$0.00,$2.30,$4419.38,Adjustment
5/29/2020,$0.00,$2.30,$4421.68,Adjustment
5/29/2020,$0.00,$2.30,$4423.98,Adjustment
5/29/2020,$0.00,$2.30,$4426.28,Adjustment
5/29/2020,$0.00,$2.30,$4428.58,Adjustment
5/29/2020,$0.00,$2.30,$4430.88,Adjustment
5/29/2020,$0.00,$2.30,$4433.18,Adjustment
5/30/2020,$0.00,$2.01,$4435.19,Adjustment
5/30/2020,$0.00,$2.01,$4437.20,Adjustment
5/30/2020,$0.00,$1.96,$4439.16,Adjustment
5/30/2020,$0.00,$1.96,$4441.12,Adjustment
5/30/2020,$0.00,$1.96,$4443.08,Adjustment
5/30/2020,$0.00,$1.96,$4445.04,Adjustment
5/30/2020,$0.00,$1.96,$4447.00,Adjustment
5/30/2020,$0.00,$1.87,$4448.87,Adjustment
5/30/2020,$0.00,$1.87,$4450.74,Adjustment
5/30/2020,$0.00,$1.87,$4452.61,Adjustment
5/30/2020,$0.00,$1.85,$4454.46,Adjustment
5/30/2020,$55.45,$0.00,$4399.01,Print
5/30/2020,$0.00,$1.27,$4400.28,Adjustment
5/30/2020,$0.00,$1.27,$4401.55,Adjustment
5/30/2020,$32.91,$0.00,$4368.64,Print
5/30/2020,$0.00,$1.25,$4369.89,Adjustment
5/30/2020,$0.00,$1.25,$4371.14,Adjustment
5/30/2020,$0.00,$1.25,$4372.39,Adjustment
5/30/2020,$0.00,$1.24,$4373.63,Adjustment
5/30/2020,$0.00,$1.24,$4374.87,Adjustment
5/30/2020,$0.00,$1.24,$4376.11,Adjustment
5/30/2020,$0.00,$1.24,$4377.35,Adjustment
5/30/2020,$0.00,$1.24,$4378.59,Adjustment
5/30/2020,$0.00,$1.24,$4379.83,Adjustment
5/30/2020,$0.00,$1.24,$4381.07,Adjustment
5/30/2020,$0.00,$1.24,$4382.31,Adjustment
5/30/2020,$0.00,$1.24,$4383.55,Adjustment
5/30/2020,$0.00,$1.24,$4384.79,Adjustment
5/30/2020,$0.00,$1.24,$4386.03,Adjustment
5/30/2020,$0.00,$1.24,$4387.27,Adjustment
5/30/2020,$0.00,$1.24,$4388.51,Adjustment
5/30/2020,$0.00,$1.24,$4389.75,Adjustment
5/30/2020,$0.00,$1.24,$4390.99,Adjustment
5/30/2020,$0.00,$1.24,$4392.23,Adjustment
5/30/2020,$0.00,$1.24,$4393.47,Adjustment
5/30/2020,$0.00,$1.24,$4394.71,Adjustment
5/30/2020,$0.00,$1.24,$4395.95,Adjustment
5/30/2020,$0.00,$1.24,$4397.19,Adjustment
5/30/2020,$0.00,$1.24,$4398.43,Adjustment
5/30/2020,$0.00,$1.24,$4399.67,Adjustment
5/30/2020,$0.00,$1.24,$4400.91,Adjustment
5/30/2020,$0.00,$1.24,$4402.15,Adjustment
5/30/2020,$0.00,$1.21,$4403.36,Adjustment
5/30/2020,$0.00,$1.22,$4404.58,Adjustment
5/30/2020,$0.00,$1.21,$4405.79,Adjustment
5/30/2020,$0.00,$1.21,$4407.00,Adjustment
5/30/2020,$0.00,$1.22,$4408.22,Adjustment
5/30/2020,$0.00,$1.21,$4409.43,Adjustment
5/30/2020,$0.00,$1.21,$4410.64,Adjustment
5/30/2020,$0.00,$1.22,$4411.86,Adjustment
5/30/2020,$0.00,$1.21,$4413.07,Adjustment
5/30/2020,$0.00,$1.22,$4414.29,Adjustment
5/30/2020,$0.00,$1.21,$4415.50,Adjustment
5/30/2020,$0.00,$1.22,$4416.72,Adjustment
5/30/2020,$0.00,$1.22,$4417.94,Adjustment
5/30/2020,$0.00,$1.21,$4419.15,Adjustment
5/30/2020,$0.00,$1.21,$4420.36,Adjustment
5/30/2020,$0.00,$1.22,$4421.58,Adjustment
5/30/2020,$0.00,$1.22,$4422.80,Adjustment
5/30/2020,$0.00,$1.22,$4424.02,Adjustment
5/30/2020,$0.00,$1.22,$4425.24,Adjustment
5/30/2020,$0.00,$1.22,$4426.46,Adjustment
5/30/2020,$0.00,$1.21,$4427.67,Adjustment
5/30/2020,$0.00,$1.21,$4428.88,Adjustment
5/30/2020,$0.00,$1.22,$4430.10,Adjustment
5/30/2020,$0.00,$1.22,$4431.32,Adjustment
5/30/2020,$0.00,$1.22,$4432.54,Adjustment
5/30/2020,$0.00,$1.22,$4433.76,Adjustment
5/30/2020,$0.00,$1.22,$4434.98,Adjustment
5/30/2020,$0.00,$1.21,$4436.19,Adjustment
5/30/2020,$0.00,$1.22,$4437.41,Adjustment
5/30/2020,$0.00,$1.21,$4438.62,Adjustment
5/30/2020,$0.00,$1.22,$4439.84,Adjustment
5/30/2020,$0.00,$1.22,$4441.06,Adjustment
5/30/2020,$0.00,$1.22,$4442.28,Adjustment
5/30/2020,$0.00,$1.22,$4443.50,Adjustment
5/30/2020,$0.00,$1.22,$4444.72,Adjustment
5/30/2020,$0.00,$1.22,$4445.94,Adjustment
5/30/2020,$0.00,$1.22,$4447.16,Adjustment
5/30/2020,$0.00,$1.19,$4448.35,Adjustment
5/30/2020,$0.00,$1.19,$4449.54,Adjustment
5/30/2020,$0.00,$1.19,$4450.73,Adjustment
5/30/2020,$0.00,$1.19,$4451.92,Adjustment
5/30/2020,$0.00,$1.19,$4453.11,Adjustment
5/30/2020,$0.00,$1.19,$4454.30,Adjustment
5/30/2020,$0.00,$1.19,$4455.49,Adjustment
5/30/2020,$0.00,$1.19,$4456.68,Adjustment
5/30/2020,$0.00,$1.19,$4457.87,Adjustment
5/30/2020,$0.00,$1.19,$4459.06,Adjustment
5/30/2020,$0.00,$1.19,$4460.25,Adjustment
5/30/2020,$0.00,$1.19,$4461.44,Adjustment
5/30/2020,$0.00,$1.19,$4462.63,Adjustment
5/30/2020,$0.00,$1.19,$4463.82,Adjustment
5/30/2020,$0.00,$1.19,$4465.01,Adjustment
5/30/2020,$0.00,$1.19,$4466.20,Adjustment
5/30/2020,$0.00,$1.19,$4467.39,Adjustment
5/30/2020,$0.00,$1.19,$4468.58,Adjustment
5/30/2020,$0.00,$1.19,$4469.77,Adjustment
5/30/2020,$0.00,$1.19,$4470.96,Adjustment
5/30/2020,$0.00,$1.19,$4472.15,Adjustment
5/30/2020,$0.00,$1.19,$4473.34,Adjustment
5/30/2020,$0.00,$1.19,$4474.53,Adjustment
5/30/2020,$0.00,$1.12,$4475.65,Adjustment
5/30/2020,$0.00,$1.12,$4476.77,Adjustment
5/30/2020,$0.00,$1.12,$4477.89,Adjustment
5/30/2020,$0.00,$1.12,$4479.01,Adjustment
5/30/2020,$0.00,$1.12,$4480.13,Adjustment
5/30/2020,$0.00,$1.11,$4481.24,Adjustment
5/30/2020,$1.11,$0.00,$4480.13,Adjustment
5/30/2020,$1.11,$0.00,$4479.02,Adjustment
5/30/2020,$1.11,$0.00,$4477.91,Adjustment
5/30/2020,$4.00,$0.00,$4473.91,Print
5/30/2020,$3.31,$0.00,$4470.60,Print
5/30/2020,$3.31,$0.00,$4467.29,Print
5/30/2020,$4.08,$0.00,$4463.21,Print
5/30/2020,$2.78,$0.00,$4460.43,Print
5/30/2020,$3.31,$0.00,$4457.12,Print
5/30/2020,$3.23,$0.00,$4453.89,Print
5/30/2020,$2.84,$0.00,$4451.05,Print
5/30/2020,$3.39,$0.00,$4447.66,Print
5/30/2020,$3.25,$0.00,$4444.41,Print
5/30/2020,$3.25,$0.00,$4441.16,Print
5/30/2020,$3.23,$0.00,$4437.93,Print
5/30/2020,$3.31,$0.00,$4434.62,Print
5/30/2020,$3.31,$0.00,$4431.31,Print
5/30/2020,$3.31,$0.00,$4428.00,Print
5/30/2020,$3.25,$0.00,$4424.75,Print
5/30/2020,$3.25,$0.00,$4421.50,Print
5/30/2020,$3.31,$0.00,$4418.19,Print
5/30/2020,$3.25,$0.00,$4414.94,Print
5/30/2020,$3.25,$0.00,$4411.69,Print
5/30/2020,$26.15,$0.00,$4385.54,Print
5/30/2020,$3.25,$0.00,$4382.29,Print
5/30/2020,$3.25,$0.00,$4379.04,Print
5/30/2020,$3.31,$0.00,$4375.73,Print
5/30/2020,$3.25,$0.00,$4372.48,Print
5/30/2020,$2.84,$0.00,$4369.64,Print
5/30/2020,$2.84,$0.00,$4366.80,Print
5/30/2020,$2.76,$0.00,$4364.04,Print
5/30/2020,$68.84,$0.00,$4295.20,Print
5/30/2020,$4.00,$0.00,$4291.20,Print
5/30/2020,$3.21,$0.00,$4287.99,Print
5/30/2020,$3.25,$0.00,$4284.74,Print
5/30/2020,$69.36,$0.00,$4215.38,Print
5/30/2020,$3.31,$0.00,$4212.07,Print
5/30/2020,$3.25,$0.00,$4208.82,Print
5/30/2020,$7.80,$0.00,$4201.02,Print
5/30/2020,$3.25,$0.00,$4197.77,Print
5/30/2020,$4.00,$0.00,$4193.77,Print
5/30/2020,$5.27,$0.00,$4188.50,Print
5/30/2020,$2.78,$0.00,$4185.72,Print
5/30/2020,$2.84,$0.00,$4182.88,Print
5/30/2020,$2.76,$0.00,$4180.12,Print
5/30/2020,$2.76,$0.00,$4177.36,Print
5/30/2020,$2.76,$0.00,$4174.60,Print
5/30/2020,$2.78,$0.00,$4171.82,Print
5/30/2020,$2.84,$0.00,$4168.98,Print
5/30/2020,$2.78,$0.00,$4166.20,Print
5/30/2020,$2.78,$0.00,$4163.42,Print
5/30/2020,$2.74,$0.00,$4160.68,Print
5/30/2020,$2.84,$0.00,$4157.84,Print
5/30/2020,$2.84,$0.00,$4155.00,Print
5/30/2020,$2.84,$0.00,$4152.16,Print
5/30/2020,$2.78,$0.00,$4149.38,Print
5/30/2020,$2.76,$0.00,$4146.62,Print
5/30/2020,$2.84,$0.00,$4143.78,Print
5/30/2020,$2.84,$0.00,$4140.94,Print
5/30/2020,$46.01,$0.00,$4094.93,Print
5/30/2020,$2.76,$0.00,$4092.17,Print
5/30/2020,$4.08,$0.00,$4088.09,Print
5/30/2020,$2.76,$0.00,$4085.33,Print
5/30/2020,$32.91,$0.00,$4052.42,Print
5/30/2020,$2.74,$0.00,$4049.68,Print
5/30/2020,$2.84,$0.00,$4046.84,Print
5/30/2020,$8.45,$0.00,$4038.39,Print
5/30/2020,$3.21,$0.00,$4035.18,Print
5/30/2020,$2.78,$0.00,$4032.40,Print
5/30/2020,$2.84,$0.00,$4029.56,Print
5/30/2020,$2.78,$0.00,$4026.78,Print
5/30/2020,$2.78,$0.00,$4024.00,Print
5/30/2020,$2.76,$0.00,$4021.24,Print
5/30/2020,$2.78,$0.00,$4018.46,Print
5/30/2020,$2.74,$0.00,$4015.72,Print
5/30/2020,$2.78,$0.00,$4012.94,Print
5/30/2020,$3.31,$0.00,$4009.63,Print
5/30/2020,$3.05,$0.00,$4006.58,Print
5/30/2020,$2.76,$0.00,$4003.82,Print
5/30/2020,$2.84,$0.00,$4000.98,Print
5/30/2020,$2.84,$0.00,$3998.14,Print
5/30/2020,$3.25,$0.00,$3994.89,Print
5/30/2020,$3.05,$0.00,$3991.84,Print
5/30/2020,$2.93,$0.00,$3988.91,Print
5/30/2020,$2.84,$0.00,$3986.07,Print
5/30/2020,$2.84,$0.00,$3983.23,Print
5/30/2020,$3.23,$0.00,$3980.00,Print
5/30/2020,$2.78,$0.00,$3977.22,Print
5/30/2020,$3.23,$0.00,$3973.99,Print
5/30/2020,$2.84,$0.00,$3971.15,Print
5/30/2020,$2.84,$0.00,$3968.31,Print
5/30/2020,$2.74,$0.00,$3965.57,Print
5/30/2020,$2.84,$0.00,$3962.73,Print
5/30/2020,$2.93,$0.00,$3959.80,Print
5/30/2020,$2.84,$0.00,$3956.96,Print
5/30/2020,$3.97,$0.00,$3952.99,Print
5/30/2020,$2.76,$0.00,$3950.23,Print
5/30/2020,$2.78,$0.00,$3947.45,Print
5/30/2020,$11.10,$0.00,$3936.35,Print
5/30/2020,$5.12,$0.00,$3931.23,Print
5/30/2020,$4.00,$0.00,$3927.23,Print
5/30/2020,$4.18,$0.00,$3923.05,Print
5/30/2020,$4.08,$0.00,$3918.97,Print
5/30/2020,$4.08,$0.00,$3914.89,Print
5/30/2020,$2.84,$0.00,$3912.05,Print
5/30/2020,$2.84,$0.00,$3909.21,Print
5/30/2020,$3.21,$0.00,$3906.00,Print
5/30/2020,$2.84,$0.00,$3903.16,Print
5/30/2020,$3.93,$0.00,$3899.23,Print
5/30/2020,$4.00,$0.00,$3895.23,Print
5/30/2020,$2.84,$0.00,$3892.39,Print
5/30/2020,$5.12,$0.00,$3887.27,Print
5/30/2020,$3.25,$0.00,$3884.02,Print
5/30/2020,$5.27,$0.00,$3878.75,Print
5/30/2020,$3.21,$0.00,$3875.54,Print
5/30/2020,$3.21,$0.00,$3872.33,Print
5/30/2020,$2.74,$0.00,$3869.59,Print
5/30/2020,$2.74,$0.00,$3866.85,Print
5/30/2020,$3.25,$0.00,$3863.60,Print
5/30/2020,$2.84,$0.00,$3860.76,Print
5/30/2020,$2.84,$0.00,$3857.92,Print
5/30/2020,$2.78,$0.00,$3855.14,Print
5/30/2020,$3.31,$0.00,$3851.83,Print
5/30/2020,$2.84,$0.00,$3848.99,Print
5/30/2020,$3.25,$0.00,$3845.74,Print
5/30/2020,$2.78,$0.00,$3842.96,Print
5/30/2020,$2.78,$0.00,$3840.18,Print
5/30/2020,$2.84,$0.00,$3837.34,Print
5/30/2020,$2.84,$0.00,$3834.50,Print
5/30/2020,$2.78,$0.00,$3831.72,Print
5/30/2020,$2.74,$0.00,$3828.98,Print
5/30/2020,$2.84,$0.00,$3826.14,Print
5/30/2020,$2.74,$0.00,$3823.40,Print
5/30/2020,$2.78,$0.00,$3820.62,Print
5/30/2020,$5.08,$0.00,$3815.54,Print
5/30/2020,$4.08,$0.00,$3811.46,Print
5/30/2020,$2.78,$0.00,$3808.68,Print
5/30/2020,$2.78,$0.00,$3805.90,Print
5/30/2020,$3.25,$0.00,$3802.65,Print
5/30/2020,$2.74,$0.00,$3799.91,Print
5/30/2020,$2.76,$0.00,$3797.15,Print
5/30/2020,$3.25,$0.00,$3793.90,Print
5/30/2020,$3.18,$0.00,$3790.72,Print
5/30/2020,$10.33,$0.00,$3780.39,Print
5/30/2020,$10.33,$0.00,$3770.06,Print
5/30/2020,$2.74,$0.00,$3767.32,Print
5/30/2020,$2.78,$0.00,$3764.54,Print
5/30/2020,$2.78,$0.00,$3761.76,Print
5/30/2020,$3.25,$0.00,$3758.51,Print
5/30/2020,$2.74,$0.00,$3755.77,Print
5/30/2020,$2.74,$0.00,$3753.03,Print
5/30/2020,$2.84,$0.00,$3750.19,Print
5/30/2020,$2.78,$0.00,$3747.41,Print
5/30/2020,$2.78,$0.00,$3744.63,Print
5/30/2020,$3.23,$0.00,$3741.40,Print
5/30/2020,$3.31,$0.00,$3738.09,Print
5/30/2020,$2.84,$0.00,$3735.25,Print
5/30/2020,$3.25,$0.00,$3732.00,Print
5/30/2020,$3.25,$0.00,$3728.75,Print

